AAAAACGGCGC -> AAAACGGCGCG
AAAACGGCGCG -> AAACGGCGCGT
AAAACTAACTG -> AAACTAACTGC
AAAATGTCCGC -> AAATGTCCGCG
AAACACGCAAG -> AACACGCAAGC
AAACGACTAGA -> AACGACTAGAC
AAACGGCGCGT -> AACGGCGCGTC
AAACGGCTGCG -> AACGGCTGCGG
AAACTAACTGC -> AACTAACTGCC
AAAGTAAAAAC -> AAGTAAAAACG
AAAGTCCGCAG -> AAGTCCGCAGC
AAAGTCCGTTA -> AAGTCCGTTAA
AAATAAACACG -> AATAAACACGC
AAATCTGCCTG -> AATCTGCCTGC
AAATGCCGTGA -> AATGCCGTGAC
AAATGTCCGCG -> AATGTCCGCGT
AACAAATCTGC -> ACAAATCTGCC
AACACACTTTT -> ACACACTTTTC
AACACGCAAGC -> ACACGCAAGCA
AACAGCTTAGG -> ACAGCTTAGGC
AACATCCTTTA -> ACATCCTTTAG
AACATTCCCCC -> ACATTCCCCCG
AACATTCCCGA -> ACATTCCCGAA
AACCACAAGTC -> ACCACAAGTCC
AACCCCGACAG -> ACCCCGACAGA
AACCCTCTGTA -> ACCCTCTGTAC
AACCGTGACGC -> ACCGTGACGCC
AACCGTGAGCA -> ACCGTGAGCAG
AACCTAGATCA -> ACCTAGATCAT
AACCTCGTCTC -> ACCTCGTCTCG
AACCTGCGAGA -> ACCTGCGAGAA
AACGACACATG -> ACGACACATGC
AACGACTAGAC -> ACGACTAGACG
AACGAGCTAGC -> ACGAGCTAGCT
AACGATACTCA -> ACGATACTCAT
AACGATTTCAT -> ACGATTTCATA
AACGGAATACT -> ACGGAATACTA
AACGGCGCGTC -> ACGGCGCGTCT
AACGGCTGCGG -> ACGGCTGCGGG
AACGTGCGGGC -> ACGTGCGGGCG
AACGTTGATAG -> ACGTTGATAGC
AACTAACTGCC -> ACTAACTGCCT
AACTCCCTGAT -> ACTCCCTGATC
AACTCGAGGGT -> ACTCGAGGGTT
AACTCTCGTAT -> ACTCTCGTATA
AACTGCCTAAT -> ACTGCCTAATT
AACTTGAGTTG -> ACTTGAGTTGG
AAGAACCTAGA -> AGAACCTAGAT
AAGAACGAGCT -> AGAACGAGCTA
AAGAAGGCTGG -> AGAAGGCTGGC
AAGACAAATAA -> AGACAAATAAA
AAGACTTACCG -> AGACTTACCGC
AAGAGCGTTTC -> AGAGCGTTTCC
AAGCAGAGACG -> AGCAGAGACGC
AAGCATAGAAC -> AGCATAGAACC
AAGCTCTACTT -> AGCTCTACTTG
AAGCTCTCCGC -> AGCTCTCCGCT
AAGCTTAATGT -> AGCTTAATGTT
AAGCTTGATGA -> AGCTTGATGAC
AAGGAACCACA -> AGGAACCACAA
AAGGATCGGCA -> AGGATCGGCAG
AAGGATGCTGG -> AGGATGCTGGA
AAGGCCGTGCC -> AGGCCGTGCCA
AAGGCTGGCGC -> AGGCTGGCGCA
AAGGGGTTAAG -> AGGGGTTAAGG
AAGGGTTAAAG -> AGGGTTAAAGT
AAGGTACAGCT -> AGGTACAGCTC
AAGGTCAACTC -> AGGTCAACTCT
AAGGTTCGGGT -> AGGTTCGGGTA
AAGTAAAAACG -> AGTAAAAACGG
AAGTACCAGAT -> AGTACCAGATG
AAGTCCCATTC -> AGTCCCATTCG
AAGTCCGCAGC -> AGTCCGCAGCA
AAGTCCGTTAA -> AGTCCGTTAAA
AAGTCGGTCGG -> AGTCGGTCGGT
AAGTGGATCAG -> AGTGGATCAGC
AAGTGTAGATC -> AGTGTAGATCT
AAGTGTTACTT -> AGTGTTACTTC
AAGTTTAGAGG -> AGTTTAGAGGA
AATAAACACGC -> ATAAACACGCA
AATAATTTGCG -> ATAATTTGCGT
AATACGCCAGT -> ATACGCCAGTG
AATACTAATTT -> ATACTAATTTA
AATATCTTACA -> ATATCTTACAC
AATATTCGACC -> ATATTCGACCC
AATCATTAGAA -> ATCATTAGAAT
AATCTGCCTGC -> ATCTGCCTGCA
AATCTTTTACA -> ATCTTTTACAG
AATGACTTTTC -> ATGACTTTTCT
AATGAGCCTGG -> ATGAGCCTGGT
AATGCCGTGAC -> ATGCCGTGACA
AATGCTGTTCT -> ATGCTGTTCTT
AATGTCCGCGT -> ATGTCCGCGTC
AATGTTTGACG -> ATGTTTGACGC
AATTAAAGTCC -> ATTAAAGTCCG
AATTAATCTTT -> ATTAATCTTTT
AATTATTCGGA -> ATTATTCGGAA
AATTCTATCAT -> ATTCTATCATT
AATTGTGGCAT -> ATTGTGGCATC
AATTTAAACGG -> ATTTAAACGGC
AATTTAGTGGC -> ATTTAGTGGCC
AATTTCGTCAA -> ATTTCGTCAAG
AATTTGCGTAG -> ATTTGCGTAGT
ACAAATAAACA -> CAAATAAACAC
ACAAATCTGCC -> CAAATCTGCCT
ACAAGGTTCGG -> CAAGGTTCGGG
ACAAGTCCCAT -> CAAGTCCCATT
ACAATAATTTG -> CAATAATTTGC
ACACACTTTTC -> CACACTTTTCA
ACACATGCCCC -> CACATGCCCCA
ACACCACTGCG -> CACCACTGCGC
ACACCATAACA -> CACCATAACAT
ACACGCAAGCA -> CACGCAAGCAG
ACACGCCGAAG -> CACGCCGAAGC
ACACGCGATTT -> CACGCGATTTC
ACACTTTGTCG -> CACTTTGTCGT
ACACTTTTCAC -> CACTTTTCACG
ACACTTTTTAC -> CACTTTTTACA
ACAGACCAGAT -> CAGACCAGATC
ACAGACCGCAG -> CAGACCGCAGT
ACAGCTAATGA -> CAGCTAATGAG
ACAGCTCAGTG -> CAGCTCAGTGA
ACAGCTTAGGC -> CAGCTTAGGCA
ACAGGGTGCCT -> CAGGGTGCCTC
ACAGTAGTTAC -> CAGTAGTTACC
ACAGTGACCCT -> CAGTGACCCTG
ACAGTTTTGTT -> CAGTTTTGTTA
ACATAGAGTGA -> CATAGAGTGAG
ACATCCTACAA -> CATCCTACAAT
ACATCCTTTAG -> CATCCTTTAGG
ACATGCCCCAG -> CATGCCCCAGG
ACATTCCCCCG -> CATTCCCCCGT
ACATTCCCGAA -> CATTCCCGAAG
ACATTGGTTTA -> CATTGGTTTAA
ACCAACGTTGA -> CCAACGTTGAT
ACCAAGGTACA -> CCAAGGTACAG
ACCACAAGTCC -> CCACAAGTCCC
ACCACGGGTGA -> CCACGGGTGAC
ACCACTGCGCC -> CCACTGCGCCG
ACCAGATCACT -> CCAGATCACTA
ACCAGATGCGT -> CCAGATGCGTG
ACCAGCACCTT -> CCAGCACCTTT
ACCAGTAACCC -> CCAGTAACCCT
ACCATAACATC -> CCATAACATCC
ACCCACAGTAG -> CCCACAGTAGT
ACCCAGACACC -> CCCAGACACCA
ACCCCCTTGAA -> CCCCCTTGAAC
ACCCCGACAGA -> CCCCGACAGAC
ACCCCGGCATC -> CCCCGGCATCT
ACCCTAAGAAC -> CCCTAAGAACC
ACCCTCTGTAC -> CCCTCTGTACA
ACCCTGAATAT -> CCCTGAATATT
ACCCTGTTGTC -> CCCTGTTGTCT
ACCGCAGTAGA -> CCGCAGTAGAC
ACCGCTCATGT -> CCGCTCATGTC
ACCGGCCTGAA -> CCGGCCTGAAC
ACCGTGACAAG -> CCGTGACAAGG
ACCGTGACGCC -> CCGTGACGCCA
ACCGTGAGCAG -> CCGTGAGCAGC
ACCGTGAGCGA -> CCGTGAGCGAA
ACCTACGAGTC -> CCTACGAGTCG
ACCTAGATCAT -> CCTAGATCATG
ACCTCCCATGC -> CCTCCCATGCG
ACCTCGTCTCG -> CCTCGTCTCGA
ACCTGCGAGAA -> CCTGCGAGAAC
ACCTTTTGTGT -> CCTTTTGTGTT
ACGAACCTCGT -> CGAACCTCGTC
ACGAAGCTTGA -> CGAAGCTTGAT
ACGACACATGC -> CGACACATGCC
ACGACCGGCCT -> CGACCGGCCTG
ACGACTAGACG -> CGACTAGACGC
ACGAGCTAGCT -> CGAGCTAGCTC
ACGAGTCGTGA -> CGAGTCGTGAC
ACGATACTCAT -> CGATACTCATT
ACGATCCATCT -> CGATCCATCTG
ACGATGCCTCG -> CGATGCCTCGA
ACGATTTCATA -> CGATTTCATAA
ACGCAACGATA -> CGCAACGATAC
ACGCAAGCAGA -> CGCAAGCAGAG
ACGCACTAGCT -> CGCACTAGCTC
ACGCCACGGCA -> CGCCACGGCAC
ACGCCAGTGGA -> CGCCAGTGGAG
ACGCCGAAGCA -> CGCCGAAGCAT
ACGCCGCACTG -> CGCCGCACTGT
ACGCCTAAGTT -> CGCCTAAGTTT
ACGCGATTTCT -> CGCGATTTCTT
ACGCGGAAGCT -> CGCGGAAGCTC
ACGCGTGCTCG -> CGCGTGCTCGG
ACGCTAGTGGT -> CGCTAGTGGTT
ACGCTTGATGA -> CGCTTGATGAA
ACGGAATACTA -> CGGAATACTAA
ACGGCACCTAC -> CGGCACCTACG
ACGGCCGCATT -> CGGCCGCATTA
ACGGCGCGTCT -> CGGCGCGTCTA
ACGGCTGCGGG -> CGGCTGCGGGG
ACGGCTTGGAA -> CGGCTTGGAAG
ACGGGTGACTC -> CGGGTGACTCC
ACGGTAAGTCG -> CGGTAAGTCGG
ACGGTTTAATT -> CGGTTTAATTT
ACGTACACGCG -> CGTACACGCGA
ACGTCATGGCT -> CGTCATGGCTA
ACGTCCCCGAT -> CGTCCCCGATC
ACGTGCGGGCG -> CGTGCGGGCGT
ACGTGGATGCT -> CGTGGATGCTA
ACGTTGATAGC -> CGTTGATAGCT
ACTAACCCCGA -> CTAACCCCGAC
ACTAACTGCCT -> CTAACTGCCTA
ACTAATTTAGT -> CTAATTTAGTG
ACTAGACGCGG -> CTAGACGCGGA
ACTAGCTCTTG -> CTAGCTCTTGG
ACTATACGGCC -> CTATACGGCCG
ACTCATTAGGC -> CTCATTAGGCC
ACTCCCTGATC -> CTCCCTGATCA
ACTCCTATACC -> CTCCTATACCG
ACTCGAGGATG -> CTCGAGGATGC
ACTCGAGGGTT -> CTCGAGGGTTA
ACTCGGCTCGG -> CTCGGCTCGGA
ACTCGGTCACC -> CTCGGTCACCA
ACTCGTGAAGA -> CTCGTGAAGAC
ACTCTACGTCC -> CTCTACGTCCC
ACTCTCGTATA -> CTCTCGTATAG
ACTCTTCGGTA -> CTCTTCGGTAC
ACTGATTTCGG -> CTGATTTCGGA
ACTGCCATAGG -> CTGCCATAGGA
ACTGCCTAATT -> CTGCCTAATTC
ACTGCGCCGTT -> CTGCGCCGTTT
ACTGGTAGCTG -> CTGGTAGCTGT
ACTGTGACCCT -> CTGTGACCCTA
ACTGTTGGGTT -> CTGTTGGGTTA
ACTGTTTCGGC -> CTGTTTCGGCG
ACTTACCGCTC -> CTTACCGCTCA
ACTTCCACTCG -> CTTCCACTCGA
ACTTCTTGTAA -> CTTCTTGTAAC
ACTTGACTAAC -> CTTGACTAACC
ACTTGAGTTGG -> CTTGAGTTGGT
ACTTTAATTGT -> CTTTAATTGTG
ACTTTGTCGTC -> CTTTGTCGTCA
ACTTTTCACGA -> CTTTTCACGAT
ACTTTTCTGAG -> CTTTTCTGAGA
ACTTTTTACAG -> CTTTTTACAGT
AGAACCGTGAC -> GAACCGTGACG
AGAACCTAGAT -> GAACCTAGATC
AGAACGAGCTA -> GAACGAGCTAG
AGAACGGAATA -> GAACGGAATAC
AGAAGGCTGGC -> GAAGGCTGGCG
AGAATACGCCA -> GAATACGCCAG
AGACAAATAAA -> GACAAATAAAC
AGACACCATAA -> GACACCATAAC
AGACCAGATCA -> GACCAGATCAC
AGACCGCAGTA -> GACCGCAGTAG
AGACGAAGCTT -> GACGAAGCTTG
AGACGCAACGA -> GACGCAACGAT
AGACGCCTAAG -> GACGCCTAAGT
AGACGCGGAAG -> GACGCGGAAGC
AGACGCGTGCT -> GACGCGTGCTC
AGACTTACCGC -> GACTTACCGCT
AGACTTCTTGT -> GACTTCTTGTA
AGAGACGCAAC -> GAGACGCAACG
AGAGCGTTTCC -> GAGCGTTTCCA
AGAGGAGGGAC -> GAGGAGGGACA
AGAGGATGACC -> GAGGATGACCA
AGAGTGAGCCA -> GAGTGAGCCAC
AGAGTTGTCTC -> GAGTTGTCTCA
AGATCACTATA -> GATCACTATAC
AGATCATGCTG -> GATCATGCTGC
AGATCTGTTTC -> GATCTGTTTCA
AGATGCGTGGC -> GATGCGTGGCT
AGATGGCCGAC -> GATGGCCGACA
AGCAACACACT -> GCAACACACTT
AGCAATCATTA -> GCAATCATTAG
AGCACCTTTTG -> GCACCTTTTGT
AGCAGAGACGC -> GCAGAGACGCA
AGCAGCTACGT -> GCAGCTACGTG
AGCAGCTAGAC -> GCAGCTAGACG
AGCAGGAATGA -> GCAGGAATGAC
AGCATAGAACC -> GCATAGAACCG
AGCCACGCTAG -> GCCACGCTAGT
AGCCAGCGATC -> GCCAGCGATCG
AGCCATGCACC -> GCCATGCACCA
AGCCCGGCACT -> GCCCGGCACTG
AGCCTGGTTGT -> GCCTGGTTGTA
AGCGAACTCCC -> GCGAACTCCCT
AGCGATCGATC -> GCGATCGATCA
AGCGCCATTGG -> GCGCCATTGGG
AGCGTTTCCAT -> GCGTTTCCATT
AGCTAATGAGC -> GCTAATGAGCC
AGCTACAGTTT -> GCTACAGTTTT
AGCTACGTGGA -> GCTACGTGGAT
AGCTAGACGCC -> GCTAGACGCCT
AGCTAGCTCTG -> GCTAGCTCTGG
AGCTCAGTGAA -> GCTCAGTGAAG
AGCTCTACTTG -> GCTCTACTTGA
AGCTCTCCGCT -> GCTCTCCGCTA
AGCTCTGGCAC -> GCTCTGGCACC
AGCTCTTGGGG -> GCTCTTGGGGG
AGCTGTTAGCC -> GCTGTTAGCCA
AGCTTAATGTT -> GCTTAATGTTT
AGCTTAGGCAC -> GCTTAGGCACG
AGCTTGATGAC -> GCTTGATGACT
AGGAACAAATC -> GGAACAAATCT
AGGAACCACAA -> GGAACCACAAG
AGGAATGACTT -> GGAATGACTTT
AGGAGCGCCAT -> GGAGCGCCATT
AGGAGGGACAC -> GGAGGGACACT
AGGAGTTCACT -> GGAGTTCACTC
AGGATCGGCAG -> GGATCGGCAGT
AGGATGACCAA -> GGATGACCAAC
AGGATGCGCCC -> GGATGCGCCCG
AGGATGCTGGA -> GGATGCTGGAG
AGGCACGAACC -> GGCACGAACCT
AGGCCGCTATT -> GGCCGCTATTG
AGGCCGTGCCA -> GGCCGTGCCAT
AGGCGCACGCC -> GGCGCACGCCG
AGGCTGGCGCA -> GGCTGGCGCAA
AGGGACACTTT -> GGGACACTTTG
AGGGATACGAT -> GGGATACGATC
AGGGCCAAGAA -> GGGCCAAGAAG
AGGGCTACGTC -> GGGCTACGTCA
AGGGGTCGTCT -> GGGGTCGTCTT
AGGGGTTAAGG -> GGGGTTAAGGT
AGGGGTTACAG -> GGGGTTACAGG
AGGGTATTACT -> GGGTATTACTG
AGGGTCTGTAG -> GGGTCTGTAGG
AGGGTGCCTCC -> GGGTGCCTCCG
AGGGTTAAAGT -> GGGTTAAAGTC
AGGGTTAGACG -> GGGTTAGACGA
AGGTACAGCTC -> GGTACAGCTCA
AGGTCAACTCT -> GGTCAACTCTC
AGGTTCGGGTA -> GGTTCGGGTAC
AGTAAAAACGG -> GTAAAAACGGC
AGTAAAGTAAA -> GTAAAGTAAAA
AGTAACCCTCT -> GTAACCCTCTG
AGTACATCCTA -> GTACATCCTAC
AGTACCAGATG -> GTACCAGATGC
AGTAGACGCGT -> GTAGACGCGTG
AGTAGGGTATT -> GTAGGGTATTA
AGTAGTTACCG -> GTAGTTACCGT
AGTCCCATTCG -> GTCCCATTCGA
AGTCCGCAGCA -> GTCCGCAGCAA
AGTCCGTTAAA -> GTCCGTTAAAA
AGTCCGTTCTA -> GTCCGTTCTAT
AGTCGATCTAA -> GTCGATCTAAC
AGTCGGTCGGT -> GTCGGTCGGTT
AGTCGTGACTC -> GTCGTGACTCG
AGTCTGGACCC -> GTCTGGACCCC
AGTCTTGTGCA -> GTCTTGTGCAC
AGTGAAGCTTA -> GTGAAGCTTAA
AGTGACCCTGA -> GTGACCCTGAA
AGTGAGCCACG -> GTGAGCCACGC
AGTGGAGGGGT -> GTGGAGGGGTT
AGTGGATCAGC -> GTGGATCAGCC
AGTGGCAGGGA -> GTGGCAGGGAT
AGTGGCCGAGT -> GTGGCCGAGTA
AGTGGTTCGGA -> GTGGTTCGGAA
AGTGGTTTGGA -> GTGGTTTGGAC
AGTGTAGATCT -> GTGTAGATCTG
AGTGTTACTTC -> GTGTTACTTCC
AGTTACACTTT -> GTTACACTTTT
AGTTACCGTGA -> GTTACCGTGAC
AGTTCACTCGT -> GTTCACTCGTG
AGTTCCATCTG -> GTTCCATCTGG
AGTTGGTCATT -> GTTGGTCATTT
AGTTGTCTCAG -> GTTGTCTCAGT
AGTTTAGAGGA -> GTTTAGAGGAT
AGTTTTGTTAA -> GTTTTGTTAAT
ATAAACACGCA -> TAAACACGCAA
ATAAACGACTA -> TAAACGACTAG
ATAACATCCTT -> TAACATCCTTT
ATAAGACAAAT -> TAAGACAAATA
ATAATTTGCGT -> TAATTTGCGTA
ATACCGTGAGC -> TACCGTGAGCG
ATACGATCCAT -> TACGATCCATC
ATACGCCAGTG -> TACGCCAGTGG
ATACGGCCGCA -> TACGGCCGCAT
ATACTAATTTA -> TACTAATTTAG
ATACTCATTAG -> TACTCATTAGG
ATAGAACCGTG -> TAGAACCGTGA
ATAGAGTGAGC -> TAGAGTGAGCC
ATAGCAGCTAG -> TAGCAGCTAGA
ATAGCTACAGT -> TAGCTACAGTT
ATAGGAACAAA -> TAGGAACAAAT
ATAGGAGTTCA -> TAGGAGTTCAC
ATAGTTCCATC -> TAGTTCCATCT
ATATCTTACAC -> TATCTTACACG
ATATTCGACCC -> TATTCGACCCC
ATCAACTTGAG -> TCAACTTGAGT
ATCACTATACG -> TCACTATACGG
ATCAGCCCGGC -> TCAGCCCGGCA
ATCATGCTGCC -> TCATGCTGCCA
ATCATTAGAAT -> TCATTAGAATA
ATCATTATCCT -> TCATTATCCTT
ATCATTTAGTC -> TCATTTAGTCG
ATCATTTCGCA -> TCATTTCGCAT
ATCCATCTGTC -> TCCATCTGTCG
ATCCTACAATA -> TCCTACAATAA
ATCCTCCGCTA -> TCCTCCGCTAC
ATCCTTACTCT -> TCCTTACTCTT
ATCCTTTAGGG -> TCCTTTAGGGC
ATCGATCAACT -> TCGATCAACTT
ATCGCGACGAC -> TCGCGACGACC
ATCGGCAGTTA -> TCGGCAGTTAC
ATCTAACTCGA -> TCTAACTCGAG
ATCTCAAGAGC -> TCTCAAGAGCG
ATCTCACTTTA -> TCTCACTTTAA
ATCTCGTAAGT -> TCTCGTAAGTG
ATCTGCCTGCA -> TCTGCCTGCAA
ATCTGGAAGGC -> TCTGGAAGGCC
ATCTGTCGGTC -> TCTGTCGGTCG
ATCTGTTTCAA -> TCTGTTTCAAC
ATCTTACACGC -> TCTTACACGCC
ATCTTCCCATC -> TCTTCCCATCT
ATCTTTTACAG -> TCTTTTACAGC
ATCTTTTCTAC -> TCTTTTCTACC
ATGAAATGCCG -> TGAAATGCCGT
ATGAAGAACGA -> TGAAGAACGAG
ATGACCAACGT -> TGACCAACGTT
ATGACTGTGAC -> TGACTGTGACC
ATGACTTTTCT -> TGACTTTTCTG
ATGAGCCTGGT -> TGAGCCTGGTT
ATGCACCAAGG -> TGCACCAAGGT
ATGCCCCAGGA -> TGCCCCAGGAG
ATGCCGTGACA -> TGCCGTGACAT
ATGCCTACTGG -> TGCCTACTGGT
ATGCCTCGAAT -> TGCCTCGAATT
ATGCGCCCGTT -> TGCGCCCGTTG
ATGCGTGGCTC -> TGCGTGGCTCC
ATGCGTTCGTT -> TGCGTTCGTTT
ATGCTAGGCGC -> TGCTAGGCGCA
ATGCTGCCAAG -> TGCTGCCAAGT
ATGCTGGAGTG -> TGCTGGAGTGG
ATGCTGTTCTT -> TGCTGTTCTTA
ATGGCCGACAT -> TGGCCGACATT
ATGGCTAGTAG -> TGGCTAGTAGG
ATGTCCAATTA -> TGTCCAATTAA
ATGTCCGCGTC -> TGTCCGCGTCA
ATGTTTGACGC -> TGTTTGACGCT
ATTAAAATGTC -> TTAAAATGTCC
ATTAAAGTCCG -> TTAAAGTCCGC
ATTAATCTTTT -> TTAATCTTTTA
ATTACTGATTT -> TTACTGATTTC
ATTACTGCCAT -> TTACTGCCATA
ATTAGAATACG -> TTAGAATACGC
ATTAGGCCGCT -> TTAGGCCGCTA
ATTAGTACATC -> TTAGTACATCC
ATTATCCTTAC -> TTATCCTTACT
ATTATTCGGAA -> TTATTCGGAAG
ATTCCCCCGTT -> TTCCCCCGTTT
ATTCCCGAAGG -> TTCCCGAAGGA
ATTCCTGCTCT -> TTCCTGCTCTT
ATTCGACCCCG -> TTCGACCCCGG
ATTCGATCTTT -> TTCGATCTTTT
ATTCGGAAGCT -> TTCGGAAGCTC
ATTCTATCATT -> TTCTATCATTT
ATTGATTGTTG -> TTGATTGTTGT
ATTGGGCAAGG -> TTGGGCAAGGA
ATTGGTTTAAT -> TTGGTTTAATT
ATTGTGGCATC -> TTGTGGCATCT
ATTGTGGTTTC -> TTGTGGTTTCC
ATTGTTGTGTA -> TTGTTGTGTAG
ATTGTTTCACT -> TTGTTTCACTC
ATTTAAACGGC -> TTTAAACGGCT
ATTTAAGGAAC -> TTTAAGGAACC
ATTTAGTCGAT -> TTTAGTCGATC
ATTTAGTGGCC -> TTTAGTGGCCG
ATTTCATAAGA -> TTTCATAAGAC
ATTTCGCATTA -> TTTCGCATTAC
ATTTCGGAGCA -> TTTCGGAGCAG
ATTTCGTCAAG -> TTTCGTCAAGT
ATTTCTTGGTA -> TTTCTTGGTAT
ATTTGCGTAGT -> TTTGCGTAGTC
CAAATAAACAC -> AAATAAACACG
CAAATCTGCCT -> AAATCTGCCTG
CAACACACTTT -> AACACACTTTT
CAACAGCTTAG -> AACAGCTTAGG
CAACCGTGAGC -> AACCGTGAGCA
CAACGACACAT -> AACGACACATG
CAACGATACTC -> AACGATACTCA
CAACGTGCGGG -> AACGTGCGGGC
CAACGTTGATA -> AACGTTGATAG
CAACTCTCGTA -> AACTCTCGTAT
CAACTTGAGTT -> AACTTGAGTTG
CAAGAAGGCTG -> AAGAAGGCTGG
CAAGAGCGTTT -> AAGAGCGTTTC
CAAGCAGAGAC -> AAGCAGAGACG
CAAGGATGCTG -> AAGGATGCTGG
CAAGGTACAGC -> AAGGTACAGCT
CAAGGTTCGGG -> AAGGTTCGGGT
CAAGTACCAGA -> AAGTACCAGAT
CAAGTCCCATT -> AAGTCCCATTC
CAAGTGTAGAT -> AAGTGTAGATC
CAATAATTTGC -> AATAATTTGCG
CAATCATTAGA -> AATCATTAGAA
CAATGCTGTTC -> AATGCTGTTCT
CAATTAAAGTC -> AATTAAAGTCC
CACAAGTCCCA -> ACAAGTCCCAT
CACACTTTTCA -> ACACTTTTCAC
CACAGACCGCA -> ACAGACCGCAG
CACAGTAGTTA -> ACAGTAGTTAC
CACATGCCCCA -> ACATGCCCCAG
CACCAAGGTAC -> ACCAAGGTACA
CACCACTGCGC -> ACCACTGCGCC
CACCAGTAACC -> ACCAGTAACCC
CACCATAACAT -> ACCATAACATC
CACCCAGACAC -> ACCCAGACACC
CACCTACGAGT -> ACCTACGAGTC
CACCTCCCATG -> ACCTCCCATGC
CACCTTTTGTG -> ACCTTTTGTGT
CACGAACCTCG -> ACGAACCTCGT
CACGATGCCTC -> ACGATGCCTCG
CACGCAAGCAG -> ACGCAAGCAGA
CACGCACTAGC -> ACGCACTAGCT
CACGCCGAAGC -> ACGCCGAAGCA
CACGCCGCACT -> ACGCCGCACTG
CACGCGATTTC -> ACGCGATTTCT
CACGCTAGTGG -> ACGCTAGTGGT
CACGGCACCTA -> ACGGCACCTAC
CACGGGTGACT -> ACGGGTGACTC
CACTAGCTCTT -> ACTAGCTCTTG
CACTATACGGC -> ACTATACGGCC
CACTCGAGGAT -> ACTCGAGGATG
CACTCGGTCAC -> ACTCGGTCACC
CACTCGTGAAG -> ACTCGTGAAGA
CACTCTACGTC -> ACTCTACGTCC
CACTGCGCCGT -> ACTGCGCCGTT
CACTGTTGGGT -> ACTGTTGGGTT
CACTGTTTCGG -> ACTGTTTCGGC
CACTTTAATTG -> ACTTTAATTGT
CACTTTGTCGT -> ACTTTGTCGTC
CACTTTTCACG -> ACTTTTCACGA
CACTTTTTACA -> ACTTTTTACAG
CAGACACCATA -> AGACACCATAA
CAGACCAGATC -> AGACCAGATCA
CAGACCGCAGT -> AGACCGCAGTA
CAGAGACGCAA -> AGAGACGCAAC
CAGATCACTAT -> AGATCACTATA
CAGATGCGTGG -> AGATGCGTGGC
CAGCAACACAC -> AGCAACACACT
CAGCACCTTTT -> AGCACCTTTTG
CAGCCCGGCAC -> AGCCCGGCACT
CAGCGATCGAT -> AGCGATCGATC
CAGCTAATGAG -> AGCTAATGAGC
CAGCTACGTGG -> AGCTACGTGGA
CAGCTAGACGC -> AGCTAGACGCC
CAGCTCAGTGA -> AGCTCAGTGAA
CAGCTTAGGCA -> AGCTTAGGCAC
CAGGAATGACT -> AGGAATGACTT
CAGGAGCGCCA -> AGGAGCGCCAT
CAGGGATACGA -> AGGGATACGAT
CAGGGTGCCTC -> AGGGTGCCTCC
CAGTAACCCTC -> AGTAACCCTCT
CAGTAGACGCG -> AGTAGACGCGT
CAGTAGTTACC -> AGTAGTTACCG
CAGTCCGTTCT -> AGTCCGTTCTA
CAGTGAAGCTT -> AGTGAAGCTTA
CAGTGACCCTG -> AGTGACCCTGA
CAGTGGAGGGG -> AGTGGAGGGGT
CAGTTACACTT -> AGTTACACTTT
CAGTTTTGTTA -> AGTTTTGTTAA
CATAACATCCT -> ATAACATCCTT
CATAAGACAAA -> ATAAGACAAAT
CATAGAACCGT -> ATAGAACCGTG
CATAGAGTGAG -> ATAGAGTGAGC
CATAGGAACAA -> ATAGGAACAAA
CATAGGAGTTC -> ATAGGAGTTCA
CATCCTACAAT -> ATCCTACAATA
CATCCTTTAGG -> ATCCTTTAGGG
CATCTCAAGAG -> ATCTCAAGAGC
CATCTCACTTT -> ATCTCACTTTA
CATCTCGTAAG -> ATCTCGTAAGT
CATCTGGAAGG -> ATCTGGAAGGC
CATCTGTCGGT -> ATCTGTCGGTC
CATCTTCCCAT -> ATCTTCCCATC
CATGCACCAAG -> ATGCACCAAGG
CATGCCCCAGG -> ATGCCCCAGGA
CATGCGTTCGT -> ATGCGTTCGTT
CATGCTGCCAA -> ATGCTGCCAAG
CATGGCTAGTA -> ATGGCTAGTAG
CATGTCCAATT -> ATGTCCAATTA
CATTAAAATGT -> ATTAAAATGTC
CATTACTGATT -> ATTACTGATTT
CATTAGAATAC -> ATTAGAATACG
CATTAGGCCGC -> ATTAGGCCGCT
CATTAGTACAT -> ATTAGTACATC
CATTATCCTTA -> ATTATCCTTAC
CATTCCCCCGT -> ATTCCCCCGTT
CATTCCCGAAG -> ATTCCCGAAGG
CATTCGATCTT -> ATTCGATCTTT
CATTGGGCAAG -> ATTGGGCAAGG
CATTGGTTTAA -> ATTGGTTTAAT
CATTGTTTCAC -> ATTGTTTCACT
CATTTAAGGAA -> ATTTAAGGAAC
CATTTAGTCGA -> ATTTAGTCGAT
CATTTCGCATT -> ATTTCGCATTA
CCAACGTTGAT -> CAACGTTGATA
CCAAGAAGGCT -> CAAGAAGGCTG
CCAAGGTACAG -> CAAGGTACAGC
CCAAGTGTAGA -> CAAGTGTAGAT
CCAATTAAAGT -> CAATTAAAGTC
CCACAAGTCCC -> CACAAGTCCCA
CCACAGTAGTT -> CACAGTAGTTA
CCACGCTAGTG -> CACGCTAGTGG
CCACGGCACCT -> CACGGCACCTA
CCACGGGTGAC -> CACGGGTGACT
CCACTCGAGGA -> CACTCGAGGAT
CCACTCGGTCA -> CACTCGGTCAC
CCACTGCGCCG -> CACTGCGCCGT
CCAGACACCAT -> CAGACACCATA
CCAGATCACTA -> CAGATCACTAT
CCAGATGCGTG -> CAGATGCGTGG
CCAGCACCTTT -> CAGCACCTTTT
CCAGCGATCGA -> CAGCGATCGAT
CCAGGAGCGCC -> CAGGAGCGCCA
CCAGTAACCCT -> CAGTAACCCTC
CCAGTGGAGGG -> CAGTGGAGGGG
CCATAACATCC -> CATAACATCCT
CCATAGGAACA -> CATAGGAACAA
CCATAGGAGTT -> CATAGGAGTTC
CCATCTCACTT -> CATCTCACTTT
CCATCTGGAAG -> CATCTGGAAGG
CCATCTGTCGG -> CATCTGTCGGT
CCATGCACCAA -> CATGCACCAAG
CCATGCGTTCG -> CATGCGTTCGT
CCATTAGTACA -> CATTAGTACAT
CCATTCGATCT -> CATTCGATCTT
CCATTGGGCAA -> CATTGGGCAAG
CCATTGTTTCA -> CATTGTTTCAC
CCCACAGTAGT -> CCACAGTAGTT
CCCACTCGGTC -> CCACTCGGTCA
CCCAGACACCA -> CCAGACACCAT
CCCAGGAGCGC -> CCAGGAGCGCC
CCCATCTCACT -> CCATCTCACTT
CCCATGCGTTC -> CCATGCGTTCG
CCCATTCGATC -> CCATTCGATCT
CCCCAGGAGCG -> CCCAGGAGCGC
CCCCCGTTTTG -> CCCCGTTTTGC
CCCCCTTGAAC -> CCCCTTGAACC
CCCCGACAGAC -> CCCGACAGACC
CCCCGAGGGTC -> CCCGAGGGTCT
CCCCGATCCTC -> CCCGATCCTCC
CCCCGGCATCT -> CCCGGCATCTC
CCCCGTTTTGC -> CCCGTTTTGCG
CCCCTTGAACC -> CCCTTGAACCA
CCCGAAGGATC -> CCGAAGGATCG
CCCGACAGACC -> CCGACAGACCA
CCCGAGGGTCT -> CCGAGGGTCTG
CCCGATCCTCC -> CCGATCCTCCG
CCCGGCACTGT -> CCGGCACTGTT
CCCGGCATCTC -> CCGGCATCTCG
CCCGTTGTGTA -> CCGTTGTGTAT
CCCGTTTTGCG -> CCGTTTTGCGC
CCCTAAGAACC -> CCTAAGAACCT
CCCTCTGTACA -> CCTCTGTACAC
CCCTGAATATT -> CCTGAATATTC
CCCTGATCATT -> CCTGATCATTA
CCCTGTTGTCT -> CCTGTTGTCTC
CCCTTGAACCA -> CCTTGAACCAG
CCGAAGCATAG -> CGAAGCATAGA
CCGAAGGATCG -> CGAAGGATCGG
CCGACAGACCA -> CGACAGACCAG
CCGACATTGGT -> CGACATTGGTT
CCGAGGGTCTG -> CGAGGGTCTGT
CCGAGTAAAGT -> CGAGTAAAGTA
CCGATCCTCCG -> CGATCCTCCGC
CCGCACTGTTG -> CGCACTGTTGG
CCGCAGCAACA -> CGCAGCAACAC
CCGCAGTAGAC -> CGCAGTAGACG
CCGCATTAAAA -> CGCATTAAAAT
CCGCGTCAATG -> CGCGTCAATGC
CCGCTACGGTA -> CGCTACGGTAA
CCGCTATGAAG -> CGCTATGAAGA
CCGCTATTGAT -> CGCTATTGATT
CCGCTCATGTC -> CGCTCATGTCC
CCGGCACCTCC -> CGGCACCTCCC
CCGGCACTGTT -> CGGCACTGTTT
CCGGCATCTCG -> CGGCATCTCGT
CCGGCCTGAAC -> CGGCCTGAACG
CCGTGACAAGG -> CGTGACAAGGT
CCGTGACATAG -> CGTGACATAGA
CCGTGACGCCA -> CGTGACGCCAC
CCGTGAGCAGC -> CGTGAGCAGCT
CCGTGAGCGAA -> CGTGAGCGAAC
CCGTGCCATAG -> CGTGCCATAGG
CCGTTAAAACT -> CGTTAAAACTA
CCGTTCTATAA -> CGTTCTATAAA
CCGTTGTGTAT -> CGTTGTGTATC
CCGTTTCCCCG -> CGTTTCCCCGA
CCGTTTTGCGC -> CGTTTTGCGCC
CCTAAGAACCT -> CTAAGAACCTA
CCTAAGTTTAG -> CTAAGTTTAGA
CCTAATTCTAT -> CTAATTCTATC
CCTACAATAAT -> CTACAATAATT
CCTACGAGTCG -> CTACGAGTCGT
CCTACTGGTAG -> CTACTGGTAGC
CCTAGATCATG -> CTAGATCATGC
CCTAGGGCTAC -> CTAGGGCTACG
CCTATACCGTG -> CTATACCGTGA
CCTCCCATGCG -> CTCCCATGCGT
CCTCCGCTACG -> CTCCGCTACGG
CCTCCGGCACC -> CTCCGGCACCT
CCTCGAATTAA -> CTCGAATTAAT
CCTCGTCTCGA -> CTCGTCTCGAC
CCTCTGTACAC -> CTCTGTACACC
CCTGAACGATT -> CTGAACGATTT
CCTGAATATTC -> CTGAATATTCG
CCTGATCATTA -> CTGATCATTAT
CCTGCAACAGC -> CTGCAACAGCT
CCTGCGAGAAC -> CTGCGAGAACG
CCTGCTCTTTA -> CTGCTCTTTAG
CCTGGTTGTAG -> CTGGTTGTAGA
CCTGTTGTCTC -> CTGTTGTCTCG
CCTTACTCTTC -> CTTACTCTTCG
CCTTGAACCAG -> CTTGAACCAGG
CCTTTAGGGCC -> CTTTAGGGCCA
CCTTTTGTGTT -> CTTTTGTGTTA
CGAACCTCGTC -> GAACCTCGTCT
CGAACTCCCTG -> GAACTCCCTGA
CGAAGCATAGA -> GAAGCATAGAA
CGAAGCTTGAT -> GAAGCTTGATG
CGAAGGATCGG -> GAAGGATCGGC
CGAAGGGTTAA -> GAAGGGTTAAA
CGAATTAATCT -> GAATTAATCTT
CGACACATGCC -> GACACATGCCC
CGACAGACCAG -> GACAGACCAGA
CGACATTGGTT -> GACATTGGTTT
CGACCCCGGCA -> GACCCCGGCAT
CGACCGGCCTG -> GACCGGCCTGA
CGACGACCGGC -> GACGACCGGCC
CGACGGCTTGG -> GACGGCTTGGA
CGACGGTTTAA -> GACGGTTTAAT
CGACTAGACGC -> GACTAGACGCG
CGAGAACGGAA -> GAGAACGGAAT
CGAGCTAGCTC -> GAGCTAGCTCT
CGAGGATGCGC -> GAGGATGCGCC
CGAGGGTCTGT -> GAGGGTCTGTA
CGAGGGTTAGA -> GAGGGTTAGAC
CGAGTAAAGTA -> GAGTAAAGTAA
CGAGTCGTGAC -> GAGTCGTGACT
CGATACTCATT -> GATACTCATTA
CGATCAACTTG -> GATCAACTTGA
CGATCCATCTG -> GATCCATCTGT
CGATCCTCCGC -> GATCCTCCGCT
CGATCGATCAA -> GATCGATCAAC
CGATCTAACTC -> GATCTAACTCG
CGATCTTTTCT -> GATCTTTTCTA
CGATGCCTCGA -> GATGCCTCGAA
CGATTTCATAA -> GATTTCATAAG
CGATTTCTTGG -> GATTTCTTGGT
CGCAACGATAC -> GCAACGATACT
CGCAACGTGCG -> GCAACGTGCGG
CGCAAGCAGAG -> GCAAGCAGAGA
CGCACGCCGCA -> GCACGCCGCAC
CGCACTAGCTC -> GCACTAGCTCT
CGCACTGTTGG -> GCACTGTTGGG
CGCAGCAACAC -> GCAGCAACACA
CGCAGTAGACG -> GCAGTAGACGC
CGCATCTTCCC -> GCATCTTCCCA
CGCATTAAAAT -> GCATTAAAATG
CGCATTACTGA -> GCATTACTGAT
CGCCACGGCAC -> GCCACGGCACC
CGCCAGTGGAG -> GCCAGTGGAGG
CGCCATTGGGC -> GCCATTGGGCA
CGCCCACTCGG -> GCCCACTCGGT
CGCCCGTTGTG -> GCCCGTTGTGT
CGCCGAAGCAT -> GCCGAAGCATA
CGCCGCACTGT -> GCCGCACTGTT
CGCCGTTTCCC -> GCCGTTTCCCC
CGCCTAAGTTT -> GCCTAAGTTTA
CGCGACGACCG -> GCGACGACCGG
CGCGATTTCTT -> GCGATTTCTTG
CGCGGAAGCTC -> GCGGAAGCTCT
CGCGTCAATGC -> GCGTCAATGCT
CGCGTCTAGTG -> GCGTCTAGTGG
CGCGTGCTCGG -> GCGTGCTCGGA
CGCTACGGTAA -> GCTACGGTAAG
CGCTAGTGGTT -> GCTAGTGGTTC
CGCTATGAAGA -> GCTATGAAGAA
CGCTATTGATT -> GCTATTGATTG
CGCTCATGTCC -> GCTCATGTCCA
CGCTTGATGAA -> GCTTGATGAAA
CGGAAGCTCTA -> GGAAGCTCTAC
CGGAAGCTCTC -> GGAAGCTCTCC
CGGAAGTGGAT -> GGAAGTGGATC
CGGAATACTAA -> GGAATACTAAT
CGGAGCAGGAA -> GGAGCAGGAAT
CGGAGCCAGCG -> GGAGCCAGCGA
CGGATAGTTCC -> GGATAGTTCCA
CGGCACCTACG -> GGCACCTACGA
CGGCACCTCCC -> GGCACCTCCCA
CGGCACTGTTT -> GGCACTGTTTC
CGGCAGTTACA -> GGCAGTTACAC
CGGCATCTCGT -> GGCATCTCGTA
CGGCCGCATTA -> GGCCGCATTAA
CGGCCTGAACG -> GGCCTGAACGA
CGGCGACGGTT -> GGCGACGGTTT
CGGCGCGTCTA -> GGCGCGTCTAG
CGGCTCGGAGC -> GGCTCGGAGCC
CGGCTGCGGGG -> GGCTGCGGGGA
CGGCTTGGAAG -> GGCTTGGAAGG
CGGGCGTAACA -> GGGCGTAACAT
CGGGGACCCAC -> GGGGACCCACA
CGGGTACCACG -> GGGTACCACGG
CGGGTGACTCC -> GGGTGACTCCT
CGGTAAGTCGG -> GGTAAGTCGGT
CGGTACCAGCA -> GGTACCAGCAC
CGGTCACCAGT -> GGTCACCAGTA
CGGTCGAAGGG -> GGTCGAAGGGT
CGGTCGGTTTT -> GGTCGGTTTTT
CGGTTTAATTT -> GGTTTAATTTC
CGGTTTTTAAT -> GGTTTTTAATT
CGTAACATTCC -> GTAACATTCCC
CGTAAGTGTTA -> GTAAGTGTTAC
CGTACACGCGA -> GTACACGCGAT
CGTAGTCTGGA -> GTAGTCTGGAC
CGTATAGCAGC -> GTATAGCAGCT
CGTCAACGACA -> GTCAACGACAC
CGTCAAGTACC -> GTCAAGTACCA
CGTCAATGCTG -> GTCAATGCTGT
CGTCATGGCTA -> GTCATGGCTAG
CGTCCCCGATC -> GTCCCCGATCC
CGTCTAGTGGT -> GTCTAGTGGTT
CGTCTCGACGG -> GTCTCGACGGC
CGTCTTTCTTG -> GTCTTTCTTGG
CGTGAAGACTT -> GTGAAGACTTA
CGTGACAAGGT -> GTGACAAGGTT
CGTGACATAGA -> GTGACATAGAG
CGTGACGCCAC -> GTGACGCCACG
CGTGACTCGGC -> GTGACTCGGCT
CGTGAGCAGCT -> GTGAGCAGCTA
CGTGAGCGAAC -> GTGAGCGAACT
CGTGCCATAGG -> GTGCCATAGGA
CGTGCGGGCGT -> GTGCGGGCGTA
CGTGCTCGGAT -> GTGCTCGGATA
CGTGGATGCTA -> GTGGATGCTAG
CGTGGCTCCAT -> GTGGCTCCATT
CGTTAAAACTA -> GTTAAAACTAA
CGTTCGTTTGG -> GTTCGTTTGGT
CGTTCTATAAA -> GTTCTATAAAC
CGTTGATAGCT -> GTTGATAGCTA
CGTTGTGTATC -> GTTGTGTATCG
CGTTTCCATTG -> GTTTCCATTGT
CGTTTCCCCGA -> GTTTCCCCGAG
CGTTTGGTAAC -> GTTTGGTAACC
CGTTTTGCGCC -> GTTTTGCGCCC
CTAACCCCGAC -> TAACCCCGACA
CTAACTCGAGG -> TAACTCGAGGG
CTAACTGCCTA -> TAACTGCCTAA
CTAAGAACCTA -> TAAGAACCTAG
CTAAGTTTAGA -> TAAGTTTAGAG
CTAATGAGCCT -> TAATGAGCCTG
CTAATTCTATC -> TAATTCTATCA
CTAATTTAGTG -> TAATTTAGTGG
CTACAATAATT -> TACAATAATTT
CTACAGTTTTG -> TACAGTTTTGT
CTACCCTGTTG -> TACCCTGTTGT
CTACGAGTCGT -> TACGAGTCGTG
CTACGGTAAGT -> TACGGTAAGTC
CTACGTCATGG -> TACGTCATGGC
CTACGTCCCCG -> TACGTCCCCGA
CTACGTGGATG -> TACGTGGATGC
CTACTGGTAGC -> TACTGGTAGCT
CTACTTGACTA -> TACTTGACTAA
CTAGACGCCTA -> TAGACGCCTAA
CTAGACGCGGA -> TAGACGCGGAA
CTAGATCATGC -> TAGATCATGCT
CTAGCTCTGGC -> TAGCTCTGGCA
CTAGCTCTTGG -> TAGCTCTTGGG
CTAGGCGCACG -> TAGGCGCACGC
CTAGGGCTACG -> TAGGGCTACGT
CTAGTAGGGTA -> TAGTAGGGTAT
CTAGTGGTTCG -> TAGTGGTTCGG
CTAGTGGTTTG -> TAGTGGTTTGG
CTATAAACGAC -> TATAAACGACT
CTATACCGTGA -> TATACCGTGAG
CTATACGGCCG -> TATACGGCCGC
CTATCATTTAG -> TATCATTTAGT
CTATGAAGAAC -> TATGAAGAACG
CTATTGATTGT -> TATTGATTGTT
CTCAAGAGCGT -> TCAAGAGCGTT
CTCACTTTAAT -> TCACTTTAATT
CTCAGTCCGTT -> TCAGTCCGTTC
CTCAGTGAAGC -> TCAGTGAAGCT
CTCATGTCCAA -> TCATGTCCAAT
CTCATTAGGCC -> TCATTAGGCCG
CTCCATTAGTA -> TCCATTAGTAC
CTCCCATGCGT -> TCCCATGCGTT
CTCCCTGATCA -> TCCCTGATCAT
CTCCGCTACGG -> TCCGCTACGGT
CTCCGCTATGA -> TCCGCTATGAA
CTCCGGCACCT -> TCCGGCACCTC
CTCCTATACCG -> TCCTATACCGT
CTCGAATTAAT -> TCGAATTAATC
CTCGACGGCTT -> TCGACGGCTTG
CTCGAGGATGC -> TCGAGGATGCG
CTCGAGGGTTA -> TCGAGGGTTAG
CTCGCATCTTC -> TCGCATCTTCC
CTCGGAGCCAG -> TCGGAGCCAGC
CTCGGATAGTT -> TCGGATAGTTC
CTCGGCTCGGA -> TCGGCTCGGAG
CTCGGTCACCA -> TCGGTCACCAG
CTCGTAAGTGT -> TCGTAAGTGTT
CTCGTATAGCA -> TCGTATAGCAG
CTCGTCTCGAC -> TCGTCTCGACG
CTCGTGAAGAC -> TCGTGAAGACT
CTCTACGTCCC -> TCTACGTCCCC
CTCTACTTGAC -> TCTACTTGACT
CTCTCCGCTAT -> TCTCCGCTATG
CTCTCGTATAG -> TCTCGTATAGC
CTCTGGCACCC -> TCTGGCACCCA
CTCTGTACACC -> TCTGTACACCA
CTCTTCGGTAC -> TCTTCGGTACC
CTCTTGGGGGT -> TCTTGGGGGTA
CTCTTTAGATG -> TCTTTAGATGG
CTGAACGATTT -> TGAACGATTTC
CTGAATATTCG -> TGAATATTCGA
CTGAGAGTTGT -> TGAGAGTTGTC
CTGATCATTAT -> TGATCATTATC
CTGATTTCGGA -> TGATTTCGGAG
CTGCAACAGCT -> TGCAACAGCTT
CTGCCAAGTGT -> TGCCAAGTGTA
CTGCCATAGGA -> TGCCATAGGAG
CTGCCTAATTC -> TGCCTAATTCT
CTGCCTGCAAC -> TGCCTGCAACA
CTGCGAGAACG -> TGCGAGAACGG
CTGCGCCGTTT -> TGCGCCGTTTC
CTGCGGGGACC -> TGCGGGGACCC
CTGCTCTTTAG -> TGCTCTTTAGA
CTGGAAGGCCG -> TGGAAGGCCGT
CTGGACCCCCT -> TGGACCCCCTT
CTGGAGTGGCA -> TGGAGTGGCAG
CTGGCACCCAG -> TGGCACCCAGA
CTGGCGCAACG -> TGGCGCAACGT
CTGGTAGCTGT -> TGGTAGCTGTT
CTGGTTGTAGA -> TGGTTGTAGAG
CTGTACACCAC -> TGTACACCACT
CTGTAGGGGTC -> TGTAGGGGTCG
CTGTCGGTCGA -> TGTCGGTCGAA
CTGTGACCCTA -> TGTGACCCTAA
CTGTTAGCCAT -> TGTTAGCCATG
CTGTTCTTATC -> TGTTCTTATCA
CTGTTGGGTTA -> TGTTGGGTTAG
CTGTTGTCTCG -> TGTTGTCTCGC
CTGTTTCAACC -> TGTTTCAACCG
CTGTTTCGGCG -> TGTTTCGGCGA
CTTAATGTTTG -> TTAATGTTTGA
CTTACACGCCG -> TTACACGCCGA
CTTACCGCTCA -> TTACCGCTCAT
CTTACTCTTCG -> TTACTCTTCGG
CTTAGGCACGA -> TTAGGCACGAA
CTTATCATTTC -> TTATCATTTCG
CTTCCACTCGA -> TTCCACTCGAG
CTTCCCATCTC -> TTCCCATCTCA
CTTCGGTACCA -> TTCGGTACCAG
CTTCTTGTAAC -> TTCTTGTAACA
CTTGAACCAGG -> TTGAACCAGGC
CTTGACTAACC -> TTGACTAACCC
CTTGAGTTGGT -> TTGAGTTGGTC
CTTGATGAAAT -> TTGATGAAATG
CTTGATGACTG -> TTGATGACTGT
CTTGGAAGGGG -> TTGGAAGGGGT
CTTGGGGGTAT -> TTGGGGGTATG
CTTGGTATTGT -> TTGGTATTGTG
CTTGGTGTTCA -> TTGGTGTTCAC
CTTGTAACATT -> TTGTAACATTC
CTTGTGCACGC -> TTGTGCACGCA
CTTTAATTGTG -> TTTAATTGTGG
CTTTAGATGGC -> TTTAGATGGCC
CTTTAGGGCCA -> TTTAGGGCCAA
CTTTCTTGGTG -> TTTCTTGGTGT
CTTTGTCGTCA -> TTTGTCGTCAA
CTTTTACAGCT -> TTTTACAGCTA
CTTTTCACGAT -> TTTTCACGATG
CTTTTCTACCC -> TTTTCTACCCT
CTTTTCTGAGA -> TTTTCTGAGAG
CTTTTGTGTTA -> TTTTGTGTTAG
CTTTTTACAGT -> TTTTTACAGTG
GAAATGCCGTG -> AAATGCCGTGA
GAACAAATCTG -> AACAAATCTGC
GAACCACAAGT -> AACCACAAGTC
GAACCGTGACG -> AACCGTGACGC
GAACCTAGATC -> AACCTAGATCA
GAACCTCGTCT -> AACCTCGTCTC
GAACGAGCTAG -> AACGAGCTAGC
GAACGATTTCA -> AACGATTTCAT
GAACGGAATAC -> AACGGAATACT
GAACTCCCTGA -> AACTCCCTGAT
GAAGAACGAGC -> AAGAACGAGCT
GAAGACTTACC -> AAGACTTACCG
GAAGCATAGAA -> AAGCATAGAAC
GAAGCTCTACT -> AAGCTCTACTT
GAAGCTCTCCG -> AAGCTCTCCGC
GAAGCTTAATG -> AAGCTTAATGT
GAAGCTTGATG -> AAGCTTGATGA
GAAGGATCGGC -> AAGGATCGGCA
GAAGGCCGTGC -> AAGGCCGTGCC
GAAGGCTGGCG -> AAGGCTGGCGC
GAAGGGGTTAA -> AAGGGGTTAAG
GAAGGGTTAAA -> AAGGGTTAAAG
GAAGTGGATCA -> AAGTGGATCAG
GAATACGCCAG -> AATACGCCAGT
GAATACTAATT -> AATACTAATTT
GAATATTCGAC -> AATATTCGACC
GAATGACTTTT -> AATGACTTTTC
GAATTAATCTT -> AATTAATCTTT
GACAAATAAAC -> ACAAATAAACA
GACAAGGTTCG -> ACAAGGTTCGG
GACACATGCCC -> ACACATGCCCC
GACACCATAAC -> ACACCATAACA
GACACTTTGTC -> ACACTTTGTCG
GACAGACCAGA -> ACAGACCAGAT
GACATAGAGTG -> ACATAGAGTGA
GACATTGGTTT -> ACATTGGTTTA
GACCAACGTTG -> ACCAACGTTGA
GACCAGATCAC -> ACCAGATCACT
GACCCACAGTA -> ACCCACAGTAG
GACCCCCTTGA -> ACCCCCTTGAA
GACCCCGGCAT -> ACCCCGGCATC
GACCCTAAGAA -> ACCCTAAGAAC
GACCCTGAATA -> ACCCTGAATAT
GACCGCAGTAG -> ACCGCAGTAGA
GACCGGCCTGA -> ACCGGCCTGAA
GACGAAGCTTG -> ACGAAGCTTGA
GACGACCGGCC -> ACGACCGGCCT
GACGCAACGAT -> ACGCAACGATA
GACGCCACGGC -> ACGCCACGGCA
GACGCCTAAGT -> ACGCCTAAGTT
GACGCGGAAGC -> ACGCGGAAGCT
GACGCGTGCTC -> ACGCGTGCTCG
GACGCTTGATG -> ACGCTTGATGA
GACGGCTTGGA -> ACGGCTTGGAA
GACGGTTTAAT -> ACGGTTTAATT
GACGTACACGC -> ACGTACACGCG
GACTAACCCCG -> ACTAACCCCGA
GACTAGACGCG -> ACTAGACGCGG
GACTCCTATAC -> ACTCCTATACC
GACTCGGCTCG -> ACTCGGCTCGG
GACTGTGACCC -> ACTGTGACCCT
GACTTACCGCT -> ACTTACCGCTC
GACTTCTTGTA -> ACTTCTTGTAA
GACTTTTCTGA -> ACTTTTCTGAG
GAGAACGGAAT -> AGAACGGAATA
GAGACGCAACG -> AGACGCAACGA
GAGAGTTGTCT -> AGAGTTGTCTC
GAGCAGCTACG -> AGCAGCTACGT
GAGCAGGAATG -> AGCAGGAATGA
GAGCCACGCTA -> AGCCACGCTAG
GAGCCAGCGAT -> AGCCAGCGATC
GAGCCTGGTTG -> AGCCTGGTTGT
GAGCGAACTCC -> AGCGAACTCCC
GAGCGCCATTG -> AGCGCCATTGG
GAGCGTTTCCA -> AGCGTTTCCAT
GAGCTAGCTCT -> AGCTAGCTCTG
GAGGAGGGACA -> AGGAGGGACAC
GAGGATGACCA -> AGGATGACCAA
GAGGATGCGCC -> AGGATGCGCCC
GAGGGACACTT -> AGGGACACTTT
GAGGGGTTACA -> AGGGGTTACAG
GAGGGTCTGTA -> AGGGTCTGTAG
GAGGGTTAGAC -> AGGGTTAGACG
GAGTAAAGTAA -> AGTAAAGTAAA
GAGTCGTGACT -> AGTCGTGACTC
GAGTGAGCCAC -> AGTGAGCCACG
GAGTGGCAGGG -> AGTGGCAGGGA
GAGTTCACTCG -> AGTTCACTCGT
GAGTTGGTCAT -> AGTTGGTCATT
GAGTTGTCTCA -> AGTTGTCTCAG
GATACGATCCA -> ATACGATCCAT
GATACTCATTA -> ATACTCATTAG
GATAGCTACAG -> ATAGCTACAGT
GATAGTTCCAT -> ATAGTTCCATC
GATCAACTTGA -> ATCAACTTGAG
GATCACTATAC -> ATCACTATACG
GATCAGCCCGG -> ATCAGCCCGGC
GATCATGCTGC -> ATCATGCTGCC
GATCATTATCC -> ATCATTATCCT
GATCCATCTGT -> ATCCATCTGTC
GATCCTCCGCT -> ATCCTCCGCTA
GATCGATCAAC -> ATCGATCAACT
GATCGGCAGTT -> ATCGGCAGTTA
GATCTAACTCG -> ATCTAACTCGA
GATCTGTTTCA -> ATCTGTTTCAA
GATCTTTTCTA -> ATCTTTTCTAC
GATGAAATGCC -> ATGAAATGCCG
GATGACCAACG -> ATGACCAACGT
GATGACTGTGA -> ATGACTGTGAC
GATGCCTCGAA -> ATGCCTCGAAT
GATGCGCCCGT -> ATGCGCCCGTT
GATGCGTGGCT -> ATGCGTGGCTC
GATGCTAGGCG -> ATGCTAGGCGC
GATGCTGGAGT -> ATGCTGGAGTG
GATGGCCGACA -> ATGGCCGACAT
GATTGTTGTGT -> ATTGTTGTGTA
GATTTCATAAG -> ATTTCATAAGA
GATTTCGGAGC -> ATTTCGGAGCA
GATTTCTTGGT -> ATTTCTTGGTA
GCAACACACTT -> CAACACACTTT
GCAACAGCTTA -> CAACAGCTTAG
GCAACGATACT -> CAACGATACTC
GCAACGTGCGG -> CAACGTGCGGG
GCAAGCAGAGA -> CAAGCAGAGAC
GCAAGGATGCT -> CAAGGATGCTG
GCAATCATTAG -> CAATCATTAGA
GCACCAAGGTA -> CACCAAGGTAC
GCACCCAGACA -> CACCCAGACAC
GCACCTACGAG -> CACCTACGAGT
GCACCTCCCAT -> CACCTCCCATG
GCACCTTTTGT -> CACCTTTTGTG
GCACGAACCTC -> CACGAACCTCG
GCACGCACTAG -> CACGCACTAGC
GCACGCCGCAC -> CACGCCGCACT
GCACTAGCTCT -> CACTAGCTCTT
GCACTGTTGGG -> CACTGTTGGGT
GCACTGTTTCG -> CACTGTTTCGG
GCAGAGACGCA -> CAGAGACGCAA
GCAGCAACACA -> CAGCAACACAC
GCAGCTACGTG -> CAGCTACGTGG
GCAGCTAGACG -> CAGCTAGACGC
GCAGGAATGAC -> CAGGAATGACT
GCAGGGATACG -> CAGGGATACGA
GCAGTAGACGC -> CAGTAGACGCG
GCAGTTACACT -> CAGTTACACTT
GCATAGAACCG -> CATAGAACCGT
GCATCTCAAGA -> CATCTCAAGAG
GCATCTCGTAA -> CATCTCGTAAG
GCATCTTCCCA -> CATCTTCCCAT
GCATTAAAATG -> CATTAAAATGT
GCATTACTGAT -> CATTACTGATT
GCCAAGAAGGC -> CCAAGAAGGCT
GCCAAGTGTAG -> CCAAGTGTAGA
GCCACGCTAGT -> CCACGCTAGTG
GCCACGGCACC -> CCACGGCACCT
GCCAGCGATCG -> CCAGCGATCGA
GCCAGTGGAGG -> CCAGTGGAGGG
GCCATAGGAAC -> CCATAGGAACA
GCCATAGGAGT -> CCATAGGAGTT
GCCATGCACCA -> CCATGCACCAA
GCCATTGGGCA -> CCATTGGGCAA
GCCCACTCGGT -> CCCACTCGGTC
GCCCCAGGAGC -> CCCCAGGAGCG
GCCCGGCACTG -> CCCGGCACTGT
GCCCGTTGTGT -> CCCGTTGTGTA
GCCGAAGCATA -> CCGAAGCATAG
GCCGACATTGG -> CCGACATTGGT
GCCGAGTAAAG -> CCGAGTAAAGT
GCCGCACTGTT -> CCGCACTGTTG
GCCGCATTAAA -> CCGCATTAAAA
GCCGCTATTGA -> CCGCTATTGAT
GCCGTGACATA -> CCGTGACATAG
GCCGTGCCATA -> CCGTGCCATAG
GCCGTTTCCCC -> CCGTTTCCCCG
GCCTAAGTTTA -> CCTAAGTTTAG
GCCTAATTCTA -> CCTAATTCTAT
GCCTACTGGTA -> CCTACTGGTAG
GCCTCCGGCAC -> CCTCCGGCACC
GCCTCGAATTA -> CCTCGAATTAA
GCCTGAACGAT -> CCTGAACGATT
GCCTGCAACAG -> CCTGCAACAGC
GCCTGGTTGTA -> CCTGGTTGTAG
GCGAACTCCCT -> CGAACTCCCTG
GCGACGACCGG -> CGACGACCGGC
GCGACGGTTTA -> CGACGGTTTAA
GCGAGAACGGA -> CGAGAACGGAA
GCGATCGATCA -> CGATCGATCAA
GCGATTTCTTG -> CGATTTCTTGG
GCGCAACGTGC -> CGCAACGTGCG
GCGCACGCCGC -> CGCACGCCGCA
GCGCCATTGGG -> CGCCATTGGGC
GCGCCCACTCG -> CGCCCACTCGG
GCGCCCGTTGT -> CGCCCGTTGTG
GCGCCGTTTCC -> CGCCGTTTCCC
GCGCGTCTAGT -> CGCGTCTAGTG
GCGGAAGCTCT -> CGGAAGCTCTC
GCGGGCGTAAC -> CGGGCGTAACA
GCGGGGACCCA -> CGGGGACCCAC
GCGTAACATTC -> CGTAACATTCC
GCGTAGTCTGG -> CGTAGTCTGGA
GCGTCAATGCT -> CGTCAATGCTG
GCGTCTAGTGG -> CGTCTAGTGGT
GCGTGCTCGGA -> CGTGCTCGGAT
GCGTGGCTCCA -> CGTGGCTCCAT
GCGTTCGTTTG -> CGTTCGTTTGG
GCGTTTCCATT -> CGTTTCCATTG
GCTAATGAGCC -> CTAATGAGCCT
GCTACAGTTTT -> CTACAGTTTTG
GCTACGGTAAG -> CTACGGTAAGT
GCTACGTCATG -> CTACGTCATGG
GCTACGTGGAT -> CTACGTGGATG
GCTAGACGCCT -> CTAGACGCCTA
GCTAGCTCTGG -> CTAGCTCTGGC
GCTAGGCGCAC -> CTAGGCGCACG
GCTAGTAGGGT -> CTAGTAGGGTA
GCTAGTGGTTC -> CTAGTGGTTCG
GCTATGAAGAA -> CTATGAAGAAC
GCTATTGATTG -> CTATTGATTGT
GCTCAGTGAAG -> CTCAGTGAAGC
GCTCATGTCCA -> CTCATGTCCAA
GCTCCATTAGT -> CTCCATTAGTA
GCTCGGAGCCA -> CTCGGAGCCAG
GCTCGGATAGT -> CTCGGATAGTT
GCTCTACTTGA -> CTCTACTTGAC
GCTCTCCGCTA -> CTCTCCGCTAT
GCTCTGGCACC -> CTCTGGCACCC
GCTCTTGGGGG -> CTCTTGGGGGT
GCTCTTTAGAT -> CTCTTTAGATG
GCTGCCAAGTG -> CTGCCAAGTGT
GCTGCGGGGAC -> CTGCGGGGACC
GCTGGAGTGGC -> CTGGAGTGGCA
GCTGGCGCAAC -> CTGGCGCAACG
GCTGTTAGCCA -> CTGTTAGCCAT
GCTGTTCTTAT -> CTGTTCTTATC
GCTTAATGTTT -> CTTAATGTTTG
GCTTAGGCACG -> CTTAGGCACGA
GCTTGATGAAA -> CTTGATGAAAT
GCTTGATGACT -> CTTGATGACTG
GCTTGGAAGGG -> CTTGGAAGGGG
GGAACAAATCT -> GAACAAATCTG
GGAACCACAAG -> GAACCACAAGT
GGAAGCTCTAC -> GAAGCTCTACT
GGAAGCTCTCC -> GAAGCTCTCCG
GGAAGGCCGTG -> GAAGGCCGTGC
GGAAGGGGTTA -> GAAGGGGTTAA
GGAAGTGGATC -> GAAGTGGATCA
GGAATACTAAT -> GAATACTAATT
GGAATGACTTT -> GAATGACTTTT
GGACACTTTGT -> GACACTTTGTC
GGACCCACAGT -> GACCCACAGTA
GGACCCCCTTG -> GACCCCCTTGA
GGACGTACACG -> GACGTACACGC
GGAGCAGGAAT -> GAGCAGGAATG
GGAGCCAGCGA -> GAGCCAGCGAT
GGAGCGCCATT -> GAGCGCCATTG
GGAGGGACACT -> GAGGGACACTT
GGAGGGGTTAC -> GAGGGGTTACA
GGAGTGGCAGG -> GAGTGGCAGGG
GGAGTTCACTC -> GAGTTCACTCG
GGATACGATCC -> GATACGATCCA
GGATAGTTCCA -> GATAGTTCCAT
GGATCAGCCCG -> GATCAGCCCGG
GGATCGGCAGT -> GATCGGCAGTT
GGATGACCAAC -> GATGACCAACG
GGATGCGCCCG -> GATGCGCCCGT
GGATGCTAGGC -> GATGCTAGGCG
GGATGCTGGAG -> GATGCTGGAGT
GGCAAGGATGC -> GCAAGGATGCT
GGCACCCAGAC -> GCACCCAGACA
GGCACCTACGA -> GCACCTACGAG
GGCACCTCCCA -> GCACCTCCCAT
GGCACGAACCT -> GCACGAACCTC
GGCACTGTTTC -> GCACTGTTTCG
GGCAGGGATAC -> GCAGGGATACG
GGCAGTTACAC -> GCAGTTACACT
GGCATCTCAAG -> GCATCTCAAGA
GGCATCTCGTA -> GCATCTCGTAA
GGCCAAGAAGG -> GCCAAGAAGGC
GGCCGACATTG -> GCCGACATTGG
GGCCGAGTAAA -> GCCGAGTAAAG
GGCCGCATTAA -> GCCGCATTAAA
GGCCGCTATTG -> GCCGCTATTGA
GGCCGTGCCAT -> GCCGTGCCATA
GGCCTGAACGA -> GCCTGAACGAT
GGCGACGGTTT -> GCGACGGTTTA
GGCGCAACGTG -> GCGCAACGTGC
GGCGCACGCCG -> GCGCACGCCGC
GGCGCGTCTAG -> GCGCGTCTAGT
GGCGTAACATT -> GCGTAACATTC
GGCTACGTCAT -> GCTACGTCATG
GGCTAGTAGGG -> GCTAGTAGGGT
GGCTCCATTAG -> GCTCCATTAGT
GGCTCGGAGCC -> GCTCGGAGCCA
GGCTGCGGGGA -> GCTGCGGGGAC
GGCTGGCGCAA -> GCTGGCGCAAC
GGCTTGGAAGG -> GCTTGGAAGGG
GGGACACTTTG -> GGACACTTTGT
GGGACCCACAG -> GGACCCACAGT
GGGATACGATC -> GGATACGATCC
GGGCAAGGATG -> GGCAAGGATGC
GGGCCAAGAAG -> GGCCAAGAAGG
GGGCGTAACAT -> GGCGTAACATT
GGGCTACGTCA -> GGCTACGTCAT
GGGGACCCACA -> GGGACCCACAG
GGGGGTATGCC -> GGGGTATGCCT
GGGGTATGCCT -> GGGTATGCCTA
GGGGTCGTCTT -> GGGTCGTCTTT
GGGGTTAAGGT -> GGGTTAAGGTC
GGGGTTACAGG -> GGGTTACAGGG
GGGTACCACGG -> GGTACCACGGG
GGGTATGCCTA -> GGTATGCCTAC
GGGTATTACTG -> GGTATTACTGC
GGGTCGTCTTT -> GGTCGTCTTTC
GGGTCTGTAGG -> GGTCTGTAGGG
GGGTGACTCCT -> GGTGACTCCTA
GGGTGCCTCCG -> GGTGCCTCCGG
GGGTTAAAGTC -> GGTTAAAGTCC
GGGTTAAGGTC -> GGTTAAGGTCA
GGGTTACAGGG -> GGTTACAGGGT
GGGTTAGACGA -> GGTTAGACGAA
GGGTTAGTCTT -> GGTTAGTCTTG
GGTAACCTGCG -> GTAACCTGCGA
GGTAAGTCGGT -> GTAAGTCGGTC
GGTACAGCTCA -> GTACAGCTCAG
GGTACCACGGG -> GTACCACGGGT
GGTACCAGCAC -> GTACCAGCACC
GGTAGCTGTTA -> GTAGCTGTTAG
GGTATGCCTAC -> GTATGCCTACT
GGTATTACTGC -> GTATTACTGCC
GGTATTGTGGT -> GTATTGTGGTT
GGTCAACTCTC -> GTCAACTCTCG
GGTCACCAGTA -> GTCACCAGTAA
GGTCATTTAAG -> GTCATTTAAGG
GGTCGAAGGGT -> GTCGAAGGGTT
GGTCGGTTTTT -> GTCGGTTTTTA
GGTCGTCTTTC -> GTCGTCTTTCT
GGTCTGTAGGG -> GTCTGTAGGGG
GGTGACTCCTA -> GTGACTCCTAT
GGTGCCTCCGG -> GTGCCTCCGGC
GGTGTTCACAG -> GTGTTCACAGA
GGTTAAAGTCC -> GTTAAAGTCCG
GGTTAAGGTCA -> GTTAAGGTCAA
GGTTACAGGGT -> GTTACAGGGTG
GGTTAGACGAA -> GTTAGACGAAG
GGTTAGTCTTG -> GTTAGTCTTGT
GGTTCGGAAGT -> GTTCGGAAGTG
GGTTCGGGTAC -> GTTCGGGTACC
GGTTGTAGAGG -> GTTGTAGAGGA
GGTTTAATTTA -> GTTTAATTTAA
GGTTTAATTTC -> GTTTAATTTCG
GGTTTCCTAGG -> GTTTCCTAGGG
GGTTTGGACGT -> GTTTGGACGTA
GGTTTTTAATT -> GTTTTTAATTA
GTAAAAACGGC -> TAAAAACGGCG
GTAAAGTAAAA -> TAAAGTAAAAA
GTAACATTCCC -> TAACATTCCCC,TAACATTCCCG
GTAACCCTCTG -> TAACCCTCTGT
GTAACCTGCGA -> TAACCTGCGAG
GTAAGTCGGTC -> TAAGTCGGTCG
GTAAGTGTTAC -> TAAGTGTTACT
GTACACCACTG -> TACACCACTGC
GTACACGCGAT -> TACACGCGATT
GTACAGCTCAG -> TACAGCTCAGT
GTACATCCTAC -> TACATCCTACA
GTACCACGGGT -> TACCACGGGTG
GTACCAGATGC -> TACCAGATGCG
GTACCAGCACC -> TACCAGCACCT
GTAGACGCGTG -> TAGACGCGTGC
GTAGAGGAGGG -> TAGAGGAGGGA
GTAGATCTGTT -> TAGATCTGTTT
GTAGCAATCAT -> TAGCAATCATT
GTAGCTGTTAG -> TAGCTGTTAGC
GTAGGGGTCGT -> TAGGGGTCGTC
GTAGGGTATTA -> TAGGGTATTAC
GTAGTCTGGAC -> TAGTCTGGACC
GTAGTTACCGT -> TAGTTACCGTG
GTATAGCAGCT -> TATAGCAGCTA
GTATCGCGACG -> TATCGCGACGA
GTATGCCTACT -> TATGCCTACTG
GTATTACTGCC -> TATTACTGCCA
GTATTGTGGTT -> TATTGTGGTTT
GTCAACGACAC -> TCAACGACACA
GTCAACTCTCG -> TCAACTCTCGT
GTCAAGTACCA -> TCAAGTACCAG
GTCAATGCTGT -> TCAATGCTGTT
GTCACCAGTAA -> TCACCAGTAAC
GTCATGGCTAG -> TCATGGCTAGT
GTCATTTAAGG -> TCATTTAAGGA
GTCCAATTAAA -> TCCAATTAAAG
GTCCCATTCGA -> TCCCATTCGAT
GTCCCCGATCC -> TCCCCGATCCT
GTCCGCAGCAA -> TCCGCAGCAAC
GTCCGCGTCAA -> TCCGCGTCAAT
GTCCGTTAAAA -> TCCGTTAAAAC
GTCCGTTCTAT -> TCCGTTCTATA
GTCGAAGGGTT -> TCGAAGGGTTA
GTCGATCTAAC -> TCGATCTAACT
GTCGGTCGAAG -> TCGGTCGAAGG
GTCGGTCGGTT -> TCGGTCGGTTT
GTCGGTTTTTA -> TCGGTTTTTAA
GTCGTCAACGA -> TCGTCAACGAC
GTCGTCTTTCT -> TCGTCTTTCTT
GTCGTGACTCG -> TCGTGACTCGG
GTCTAGTGGTT -> TCTAGTGGTTT
GTCTCAGTCCG -> TCTCAGTCCGT
GTCTCGACGGC -> TCTCGACGGCT
GTCTCGCATCT -> TCTCGCATCTT
GTCTGGACCCC -> TCTGGACCCCC
GTCTGTAGGGG -> TCTGTAGGGGT
GTCTTGTGCAC -> TCTTGTGCACG
GTCTTTCTTGG -> TCTTTCTTGGT
GTGAAGACTTA -> TGAAGACTTAC
GTGAAGCTTAA -> TGAAGCTTAAT
GTGACAAGGTT -> TGACAAGGTTC
GTGACATAGAG -> TGACATAGAGT
GTGACCCTAAG -> TGACCCTAAGA
GTGACCCTGAA -> TGACCCTGAAT
GTGACGCCACG -> TGACGCCACGG
GTGACTCCTAT -> TGACTCCTATA
GTGACTCGGCT -> TGACTCGGCTC
GTGAGCAGCTA -> TGAGCAGCTAC
GTGAGCCACGC -> TGAGCCACGCT
GTGAGCGAACT -> TGAGCGAACTC
GTGCACGCACT -> TGCACGCACTA
GTGCCATAGGA -> TGCCATAGGAA
GTGCCTCCGGC -> TGCCTCCGGCA
GTGCGGGCGTA -> TGCGGGCGTAA
GTGCTCGGATA -> TGCTCGGATAG
GTGGAGGGGTT -> TGGAGGGGTTA
GTGGATCAGCC -> TGGATCAGCCC
GTGGATGCTAG -> TGGATGCTAGG
GTGGCAGGGAT -> TGGCAGGGATA
GTGGCATCTCA -> TGGCATCTCAA
GTGGCCGAGTA -> TGGCCGAGTAA
GTGGCTCCATT -> TGGCTCCATTA
GTGGTTCGGAA -> TGGTTCGGAAG
GTGGTTTCCTA -> TGGTTTCCTAG
GTGGTTTGGAC -> TGGTTTGGACG
GTGTAGATCTG -> TGTAGATCTGT
GTGTAGCAATC -> TGTAGCAATCA
GTGTATCGCGA -> TGTATCGCGAC
GTGTTACTTCC -> TGTTACTTCCA
GTGTTAGACTT -> TGTTAGACTTC
GTGTTCACAGA -> TGTTCACAGAC
GTTAAAACTAA -> TTAAAACTAAC
GTTAAAGTCCG -> TTAAAGTCCGT
GTTAAGGTCAA -> TTAAGGTCAAC
GTTAATATCTT -> TTAATATCTTA
GTTACACTTTT -> TTACACTTTTT
GTTACAGGGTG -> TTACAGGGTGC
GTTACCGTGAC -> TTACCGTGACA
GTTACTTCCAC -> TTACTTCCACT
GTTAGACGAAG -> TTAGACGAAGC
GTTAGACTTCT -> TTAGACTTCTT
GTTAGCCATGC -> TTAGCCATGCA
GTTAGTCTTGT -> TTAGTCTTGTG
GTTCACAGACC -> TTCACAGACCG
GTTCACTCGTG -> TTCACTCGTGA
GTTCCATCTGG -> TTCCATCTGGA
GTTCGGAAGTG -> TTCGGAAGTGG
GTTCGGGTACC -> TTCGGGTACCA
GTTCGTTTGGT -> TTCGTTTGGTA
GTTCTATAAAC -> TTCTATAAACG
GTTCTTATCAT -> TTCTTATCATT
GTTGATAGCTA -> TTGATAGCTAC
GTTGGGTTAGT -> TTGGGTTAGTC
GTTGGTCATTT -> TTGGTCATTTA
GTTGTAGAGGA -> TTGTAGAGGAG
GTTGTCTCAGT -> TTGTCTCAGTC
GTTGTCTCGCA -> TTGTCTCGCAT
GTTGTGTAGCA -> TTGTGTAGCAA
GTTGTGTATCG -> TTGTGTATCGC
GTTTAATTTAA -> TTTAATTTAAA
GTTTAATTTCG -> TTTAATTTCGT
GTTTAGAGGAT -> TTTAGAGGATG
GTTTCAACCGT -> TTTCAACCGTG
GTTTCACTCTA -> TTTCACTCTAC
GTTTCCATTGT -> TTTCCATTGTT
GTTTCCCCGAG -> TTTCCCCGAGG
GTTTCCTAGGG -> TTTCCTAGGGC
GTTTCGGCGAC -> TTTCGGCGACG
GTTTGACGCTT -> TTTGACGCTTG
GTTTGGACGTA -> TTTGGACGTAC
GTTTGGTAACC -> TTTGGTAACCT
GTTTTGCGCCC -> TTTTGCGCCCA
GTTTTGTTAAT -> TTTTGTTAATA
GTTTTTAATTA -> TTTTTAATTAT
TAAAAACGGCG -> AAAAACGGCGC
TAAAACTAACT -> AAAACTAACTG
TAAAATGTCCG -> AAAATGTCCGC
TAAACACGCAA -> AAACACGCAAG
TAAACGACTAG -> AAACGACTAGA
TAAACGGCTGC -> AAACGGCTGCG
TAAAGTAAAAA -> AAAGTAAAAAC
TAAAGTCCGCA -> AAAGTCCGCAG
TAAAGTCCGTT -> AAAGTCCGTTA
TAACATCCTTT -> AACATCCTTTA
TAACATTCCCC -> AACATTCCCCC
TAACATTCCCG -> AACATTCCCGA
TAACCCCGACA -> AACCCCGACAG
TAACCCTCTGT -> AACCCTCTGTA
TAACCTGCGAG -> AACCTGCGAGA
TAACTCGAGGG -> AACTCGAGGGT
TAACTGCCTAA -> AACTGCCTAAT
TAAGAACCTAG -> AAGAACCTAGA
TAAGACAAATA -> AAGACAAATAA
TAAGGAACCAC -> AAGGAACCACA
TAAGGTCAACT -> AAGGTCAACTC
TAAGTCGGTCG -> AAGTCGGTCGG
TAAGTGTTACT -> AAGTGTTACTT
TAAGTTTAGAG -> AAGTTTAGAGG
TAATATCTTAC -> AATATCTTACA
TAATCTTTTAC -> AATCTTTTACA
TAATGAGCCTG -> AATGAGCCTGG
TAATGTTTGAC -> AATGTTTGACG
TAATTATTCGG -> AATTATTCGGA
TAATTCTATCA -> AATTCTATCAT
TAATTGTGGCA -> AATTGTGGCAT
TAATTTAAACG -> AATTTAAACGG
TAATTTAGTGG -> AATTTAGTGGC
TAATTTCGTCA -> AATTTCGTCAA
TAATTTGCGTA -> AATTTGCGTAG
TACAATAATTT -> ACAATAATTTG
TACACCACTGC -> ACACCACTGCG
TACACGCCGAA -> ACACGCCGAAG
TACACGCGATT -> ACACGCGATTT
TACACTTTTTA -> ACACTTTTTAC
TACAGCTAATG -> ACAGCTAATGA
TACAGCTCAGT -> ACAGCTCAGTG
TACAGGGTGCC -> ACAGGGTGCCT
TACAGTGACCC -> ACAGTGACCCT
TACAGTTTTGT -> ACAGTTTTGTT
TACATCCTACA -> ACATCCTACAA
TACCACGGGTG -> ACCACGGGTGA
TACCAGATGCG -> ACCAGATGCGT
TACCAGCACCT -> ACCAGCACCTT
TACCCTGTTGT -> ACCCTGTTGTC
TACCGCTCATG -> ACCGCTCATGT
TACCGTGACAA -> ACCGTGACAAG
TACCGTGAGCG -> ACCGTGAGCGA
TACGAGTCGTG -> ACGAGTCGTGA
TACGATCCATC -> ACGATCCATCT
TACGCCAGTGG -> ACGCCAGTGGA
TACGGCCGCAT -> ACGGCCGCATT
TACGGTAAGTC -> ACGGTAAGTCG
TACGTCATGGC -> ACGTCATGGCT
TACGTCCCCGA -> ACGTCCCCGAT
TACGTGGATGC -> ACGTGGATGCT
TACTAATTTAG -> ACTAATTTAGT
TACTCATTAGG -> ACTCATTAGGC
TACTCTTCGGT -> ACTCTTCGGTA
TACTGATTTCG -> ACTGATTTCGG
TACTGCCATAG -> ACTGCCATAGG
TACTGGTAGCT -> ACTGGTAGCTG
TACTTCCACTC -> ACTTCCACTCG
TACTTGACTAA -> ACTTGACTAAC
TAGAACCGTGA -> AGAACCGTGAC
TAGAATACGCC -> AGAATACGCCA
TAGACGAAGCT -> AGACGAAGCTT
TAGACGCCTAA -> AGACGCCTAAG
TAGACGCGGAA -> AGACGCGGAAG
TAGACGCGTGC -> AGACGCGTGCT
TAGACTTCTTG -> AGACTTCTTGT
TAGAGGAGGGA -> AGAGGAGGGAC
TAGAGGATGAC -> AGAGGATGACC
TAGAGTGAGCC -> AGAGTGAGCCA
TAGATCATGCT -> AGATCATGCTG
TAGATCTGTTT -> AGATCTGTTTC
TAGATGGCCGA -> AGATGGCCGAC
TAGCAATCATT -> AGCAATCATTA
TAGCAGCTAGA -> AGCAGCTAGAC
TAGCCATGCAC -> AGCCATGCACC
TAGCTACAGTT -> AGCTACAGTTT
TAGCTCTGGCA -> AGCTCTGGCAC
TAGCTCTTGGG -> AGCTCTTGGGG
TAGCTGTTAGC -> AGCTGTTAGCC
TAGGAACAAAT -> AGGAACAAATC
TAGGAGTTCAC -> AGGAGTTCACT
TAGGCACGAAC -> AGGCACGAACC
TAGGCCGCTAT -> AGGCCGCTATT
TAGGCGCACGC -> AGGCGCACGCC
TAGGGCCAAGA -> AGGGCCAAGAA
TAGGGCTACGT -> AGGGCTACGTC
TAGGGGTCGTC -> AGGGGTCGTCT
TAGGGTATTAC -> AGGGTATTACT
TAGTACATCCT -> AGTACATCCTA
TAGTAGGGTAT -> AGTAGGGTATT
TAGTCGATCTA -> AGTCGATCTAA
TAGTCTGGACC -> AGTCTGGACCC
TAGTCTTGTGC -> AGTCTTGTGCA
TAGTGGCCGAG -> AGTGGCCGAGT
TAGTGGTTCGG -> AGTGGTTCGGA
TAGTGGTTTGG -> AGTGGTTTGGA
TAGTTACCGTG -> AGTTACCGTGA
TAGTTCCATCT -> AGTTCCATCTG
TATAAACGACT -> ATAAACGACTA
TATACCGTGAG -> ATACCGTGAGC
TATACGGCCGC -> ATACGGCCGCA
TATAGCAGCTA -> ATAGCAGCTAG
TATCATTTAGT -> ATCATTTAGTC
TATCATTTCGC -> ATCATTTCGCA
TATCCTTACTC -> ATCCTTACTCT
TATCGCGACGA -> ATCGCGACGAC
TATCTTACACG -> ATCTTACACGC
TATGAAGAACG -> ATGAAGAACGA
TATGCCTACTG -> ATGCCTACTGG
TATTACTGCCA -> ATTACTGCCAT
TATTCGACCCC -> ATTCGACCCCG
TATTCGGAAGC -> ATTCGGAAGCT
TATTGATTGTT -> ATTGATTGTTG
TATTGTGGTTT -> ATTGTGGTTTC
TCAACCGTGAG -> CAACCGTGAGC
TCAACGACACA -> CAACGACACAT
TCAACTCTCGT -> CAACTCTCGTA
TCAACTTGAGT -> CAACTTGAGTT
TCAAGAGCGTT -> CAAGAGCGTTT
TCAAGTACCAG -> CAAGTACCAGA
TCAATGCTGTT -> CAATGCTGTTC
TCACAGACCGC -> CACAGACCGCA
TCACCAGTAAC -> CACCAGTAACC
TCACGATGCCT -> CACGATGCCTC
TCACTATACGG -> CACTATACGGC
TCACTCGTGAA -> CACTCGTGAAG
TCACTCTACGT -> CACTCTACGTC
TCACTTTAATT -> CACTTTAATTG
TCAGCCCGGCA -> CAGCCCGGCAC
TCAGTCCGTTC -> CAGTCCGTTCT
TCAGTGAAGCT -> CAGTGAAGCTT
TCATAAGACAA -> CATAAGACAAA
TCATGCTGCCA -> CATGCTGCCAA
TCATGGCTAGT -> CATGGCTAGTA
TCATGTCCAAT -> CATGTCCAATT
TCATTAGAATA -> CATTAGAATAC
TCATTAGGCCG -> CATTAGGCCGC
TCATTATCCTT -> CATTATCCTTA
TCATTTAAGGA -> CATTTAAGGAA
TCATTTAGTCG -> CATTTAGTCGA
TCATTTCGCAT -> CATTTCGCATT
TCCAATTAAAG -> CCAATTAAAGT
TCCACTCGAGG -> CCACTCGAGGA
TCCATCTGGAA -> CCATCTGGAAG
TCCATCTGTCG -> CCATCTGTCGG
TCCATTAGTAC -> CCATTAGTACA
TCCATTGTTTC -> CCATTGTTTCA
TCCCATCTCAC -> CCCATCTCACT
TCCCATGCGTT -> CCCATGCGTTC
TCCCATTCGAT -> CCCATTCGATC
TCCCCCGTTTT -> CCCCCGTTTTG
TCCCCGAGGGT -> CCCCGAGGGTC
TCCCCGATCCT -> CCCCGATCCTC
TCCCGAAGGAT -> CCCGAAGGATC
TCCCTGATCAT -> CCCTGATCATT
TCCGCAGCAAC -> CCGCAGCAACA
TCCGCGTCAAT -> CCGCGTCAATG
TCCGCTACGGT -> CCGCTACGGTA
TCCGCTATGAA -> CCGCTATGAAG
TCCGGCACCTC -> CCGGCACCTCC
TCCGTTAAAAC -> CCGTTAAAACT
TCCGTTCTATA -> CCGTTCTATAA
TCCTACAATAA -> CCTACAATAAT
TCCTAGGGCTA -> CCTAGGGCTAC
TCCTATACCGT -> CCTATACCGTG
TCCTCCGCTAC -> CCTCCGCTACG
TCCTGCTCTTT -> CCTGCTCTTTA
TCCTTACTCTT -> CCTTACTCTTC
TCCTTTAGGGC -> CCTTTAGGGCC
TCGAAGGGTTA -> CGAAGGGTTAA
TCGAATTAATC -> CGAATTAATCT
TCGACCCCGGC -> CGACCCCGGCA
TCGACGGCTTG -> CGACGGCTTGG
TCGAGGATGCG -> CGAGGATGCGC
TCGAGGGTTAG -> CGAGGGTTAGA
TCGATCAACTT -> CGATCAACTTG
TCGATCTAACT -> CGATCTAACTC
TCGATCTTTTC -> CGATCTTTTCT
TCGCATCTTCC -> CGCATCTTCCC
TCGCATTACTG -> CGCATTACTGA
TCGCGACGACC -> CGCGACGACCG
TCGGAAGCTCT -> CGGAAGCTCTA
TCGGAAGTGGA -> CGGAAGTGGAT
TCGGAGCAGGA -> CGGAGCAGGAA
TCGGAGCCAGC -> CGGAGCCAGCG
TCGGATAGTTC -> CGGATAGTTCC
TCGGCAGTTAC -> CGGCAGTTACA
TCGGCGACGGT -> CGGCGACGGTT
TCGGCTCGGAG -> CGGCTCGGAGC
TCGGGTACCAC -> CGGGTACCACG
TCGGTACCAGC -> CGGTACCAGCA
TCGGTCACCAG -> CGGTCACCAGT
TCGGTCGAAGG -> CGGTCGAAGGG
TCGGTCGGTTT -> CGGTCGGTTTT
TCGGTTTTTAA -> CGGTTTTTAAT
TCGTAAGTGTT -> CGTAAGTGTTA
TCGTATAGCAG -> CGTATAGCAGC
TCGTCAACGAC -> CGTCAACGACA
TCGTCAAGTAC -> CGTCAAGTACC
TCGTCTCGACG -> CGTCTCGACGG
TCGTCTTTCTT -> CGTCTTTCTTG
TCGTGAAGACT -> CGTGAAGACTT
TCGTGACTCGG -> CGTGACTCGGC
TCGTTTGGTAA -> CGTTTGGTAAC
TCTAACTCGAG -> CTAACTCGAGG
TCTACCCTGTT -> CTACCCTGTTG
TCTACGTCCCC -> CTACGTCCCCG
TCTACTTGACT -> CTACTTGACTA
TCTAGTGGTTT -> CTAGTGGTTTG
TCTATAAACGA -> CTATAAACGAC
TCTATCATTTA -> CTATCATTTAG
TCTCAAGAGCG -> CTCAAGAGCGT
TCTCACTTTAA -> CTCACTTTAAT
TCTCAGTCCGT -> CTCAGTCCGTT
TCTCCGCTATG -> CTCCGCTATGA
TCTCGACGGCT -> CTCGACGGCTT
TCTCGCATCTT -> CTCGCATCTTC
TCTCGTAAGTG -> CTCGTAAGTGT
TCTCGTATAGC -> CTCGTATAGCA
TCTGAGAGTTG -> CTGAGAGTTGT
TCTGCCTGCAA -> CTGCCTGCAAC
TCTGGAAGGCC -> CTGGAAGGCCG
TCTGGACCCCC -> CTGGACCCCCT
TCTGGCACCCA -> CTGGCACCCAG
TCTGTACACCA -> CTGTACACCAC
TCTGTAGGGGT -> CTGTAGGGGTC
TCTGTCGGTCG -> CTGTCGGTCGA
TCTGTTTCAAC -> CTGTTTCAACC
TCTTACACGCC -> CTTACACGCCG
TCTTATCATTT -> CTTATCATTTC
TCTTCCCATCT -> CTTCCCATCTC
TCTTCGGTACC -> CTTCGGTACCA
TCTTGGGGGTA -> CTTGGGGGTAT
TCTTGGTATTG -> CTTGGTATTGT
TCTTGGTGTTC -> CTTGGTGTTCA
TCTTGTAACAT -> CTTGTAACATT
TCTTGTGCACG -> CTTGTGCACGC
TCTTTAGATGG -> CTTTAGATGGC
TCTTTCTTGGT -> CTTTCTTGGTG
TCTTTTACAGC -> CTTTTACAGCT
TCTTTTCTACC -> CTTTTCTACCC
TGAAATGCCGT -> GAAATGCCGTG
TGAACGATTTC -> GAACGATTTCA
TGAAGAACGAG -> GAAGAACGAGC
TGAAGACTTAC -> GAAGACTTACC
TGAAGCTTAAT -> GAAGCTTAATG
TGAATATTCGA -> GAATATTCGAC
TGACAAGGTTC -> GACAAGGTTCG
TGACATAGAGT -> GACATAGAGTG
TGACCAACGTT -> GACCAACGTTG
TGACCCTAAGA -> GACCCTAAGAA
TGACCCTGAAT -> GACCCTGAATA
TGACGCCACGG -> GACGCCACGGC
TGACGCTTGAT -> GACGCTTGATG
TGACTAACCCC -> GACTAACCCCG
TGACTCCTATA -> GACTCCTATAC
TGACTCGGCTC -> GACTCGGCTCG
TGACTGTGACC -> GACTGTGACCC
TGACTTTTCTG -> GACTTTTCTGA
TGAGAGTTGTC -> GAGAGTTGTCT
TGAGCAGCTAC -> GAGCAGCTACG
TGAGCCACGCT -> GAGCCACGCTA
TGAGCCTGGTT -> GAGCCTGGTTG
TGAGCGAACTC -> GAGCGAACTCC
TGAGTTGGTCA -> GAGTTGGTCAT
TGATAGCTACA -> GATAGCTACAG
TGATCATTATC -> GATCATTATCC
TGATGAAATGC -> GATGAAATGCC
TGATGACTGTG -> GATGACTGTGA
TGATTGTTGTG -> GATTGTTGTGT
TGATTTCGGAG -> GATTTCGGAGC
TGCAACAGCTT -> GCAACAGCTTA
TGCACCAAGGT -> GCACCAAGGTA
TGCACGCACTA -> GCACGCACTAG
TGCCAAGTGTA -> GCCAAGTGTAG
TGCCATAGGAA -> GCCATAGGAAC
TGCCATAGGAG -> GCCATAGGAGT
TGCCCCAGGAG -> GCCCCAGGAGC
TGCCGTGACAT -> GCCGTGACATA
TGCCTAATTCT -> GCCTAATTCTA
TGCCTACTGGT -> GCCTACTGGTA
TGCCTCCGGCA -> GCCTCCGGCAC
TGCCTCGAATT -> GCCTCGAATTA
TGCCTGCAACA -> GCCTGCAACAG
TGCGAGAACGG -> GCGAGAACGGA
TGCGCCCACTC -> GCGCCCACTCG
TGCGCCCGTTG -> GCGCCCGTTGT
TGCGCCGTTTC -> GCGCCGTTTCC
TGCGGGCGTAA -> GCGGGCGTAAC
TGCGGGGACCC -> GCGGGGACCCA
TGCGTAGTCTG -> GCGTAGTCTGG
TGCGTGGCTCC -> GCGTGGCTCCA
TGCGTTCGTTT -> GCGTTCGTTTG
TGCTAGGCGCA -> GCTAGGCGCAC
TGCTCGGATAG -> GCTCGGATAGT
TGCTCTTTAGA -> GCTCTTTAGAT
TGCTGCCAAGT -> GCTGCCAAGTG
TGCTGGAGTGG -> GCTGGAGTGGC
TGCTGTTCTTA -> GCTGTTCTTAT
TGGAAGGCCGT -> GGAAGGCCGTG
TGGAAGGGGTT -> GGAAGGGGTTA
TGGACCCCCTT -> GGACCCCCTTG
TGGACGTACAC -> GGACGTACACG
TGGAGGGGTTA -> GGAGGGGTTAC
TGGAGTGGCAG -> GGAGTGGCAGG
TGGATCAGCCC -> GGATCAGCCCG
TGGATGCTAGG -> GGATGCTAGGC
TGGCACCCAGA -> GGCACCCAGAC
TGGCAGGGATA -> GGCAGGGATAC
TGGCATCTCAA -> GGCATCTCAAG
TGGCCGACATT -> GGCCGACATTG
TGGCCGAGTAA -> GGCCGAGTAAA
TGGCGCAACGT -> GGCGCAACGTG
TGGCTAGTAGG -> GGCTAGTAGGG
TGGCTCCATTA -> GGCTCCATTAG
TGGGCAAGGAT -> GGGCAAGGATG
TGGGGGTATGC -> GGGGGTATGCC
TGGGTTAGTCT -> GGGTTAGTCTT
TGGTAACCTGC -> GGTAACCTGCG
TGGTAGCTGTT -> GGTAGCTGTTA
TGGTATTGTGG -> GGTATTGTGGT
TGGTCATTTAA -> GGTCATTTAAG
TGGTGTTCACA -> GGTGTTCACAG
TGGTTCGGAAG -> GGTTCGGAAGT
TGGTTGTAGAG -> GGTTGTAGAGG
TGGTTTAATTT -> GGTTTAATTTA
TGGTTTCCTAG -> GGTTTCCTAGG
TGGTTTGGACG -> GGTTTGGACGT
TGTAACATTCC -> GTAACATTCCC
TGTACACCACT -> GTACACCACTG
TGTAGAGGAGG -> GTAGAGGAGGG
TGTAGATCTGT -> GTAGATCTGTT
TGTAGCAATCA -> GTAGCAATCAT
TGTAGGGGTCG -> GTAGGGGTCGT
TGTATCGCGAC -> GTATCGCGACG
TGTCCAATTAA -> GTCCAATTAAA
TGTCCGCGTCA -> GTCCGCGTCAA
TGTCGGTCGAA -> GTCGGTCGAAG
TGTCGTCAACG -> GTCGTCAACGA
TGTCTCAGTCC -> GTCTCAGTCCG
TGTCTCGCATC -> GTCTCGCATCT
TGTGACCCTAA -> GTGACCCTAAG
TGTGCACGCAC -> GTGCACGCACT
TGTGGCATCTC -> GTGGCATCTCA
TGTGGTTTCCT -> GTGGTTTCCTA
TGTGTAGCAAT -> GTGTAGCAATC
TGTGTATCGCG -> GTGTATCGCGA
TGTGTTAGACT -> GTGTTAGACTT
TGTTAATATCT -> GTTAATATCTT
TGTTACTTCCA -> GTTACTTCCAC
TGTTAGACTTC -> GTTAGACTTCT
TGTTAGCCATG -> GTTAGCCATGC
TGTTCACAGAC -> GTTCACAGACC
TGTTCTTATCA -> GTTCTTATCAT
TGTTGGGTTAG -> GTTGGGTTAGT
TGTTGTCTCGC -> GTTGTCTCGCA
TGTTGTGTAGC -> GTTGTGTAGCA
TGTTTCAACCG -> GTTTCAACCGT
TGTTTCACTCT -> GTTTCACTCTA
TGTTTCGGCGA -> GTTTCGGCGAC
TGTTTGACGCT -> GTTTGACGCTT
TTAAAACTAAC -> TAAAACTAACT
TTAAAATGTCC -> TAAAATGTCCG
TTAAACGGCTG -> TAAACGGCTGC
TTAAAGTCCGC -> TAAAGTCCGCA
TTAAAGTCCGT -> TAAAGTCCGTT
TTAAGGAACCA -> TAAGGAACCAC
TTAAGGTCAAC -> TAAGGTCAACT
TTAATATCTTA -> TAATATCTTAC
TTAATCTTTTA -> TAATCTTTTAC
TTAATGTTTGA -> TAATGTTTGAC
TTAATTATTCG -> TAATTATTCGG
TTAATTGTGGC -> TAATTGTGGCA
TTAATTTAAAC -> TAATTTAAACG
TTAATTTCGTC -> TAATTTCGTCA
TTACACGCCGA -> TACACGCCGAA
TTACACTTTTT -> TACACTTTTTA
TTACAGCTAAT -> TACAGCTAATG
TTACAGGGTGC -> TACAGGGTGCC
TTACAGTGACC -> TACAGTGACCC
TTACCGCTCAT -> TACCGCTCATG
TTACCGTGACA -> TACCGTGACAA
TTACTCTTCGG -> TACTCTTCGGT
TTACTGATTTC -> TACTGATTTCG
TTACTGCCATA -> TACTGCCATAG
TTACTTCCACT -> TACTTCCACTC
TTAGAATACGC -> TAGAATACGCC
TTAGACGAAGC -> TAGACGAAGCT
TTAGACTTCTT -> TAGACTTCTTG
TTAGAGGATGA -> TAGAGGATGAC
TTAGATGGCCG -> TAGATGGCCGA
TTAGCCATGCA -> TAGCCATGCAC
TTAGGCACGAA -> TAGGCACGAAC
TTAGGCCGCTA -> TAGGCCGCTAT
TTAGGGCCAAG -> TAGGGCCAAGA
TTAGTACATCC -> TAGTACATCCT
TTAGTCGATCT -> TAGTCGATCTA
TTAGTCTTGTG -> TAGTCTTGTGC
TTAGTGGCCGA -> TAGTGGCCGAG
TTATCATTTCG -> TATCATTTCGC
TTATCCTTACT -> TATCCTTACTC
TTATTCGGAAG -> TATTCGGAAGC
TTCAACCGTGA -> TCAACCGTGAG
TTCACAGACCG -> TCACAGACCGC
TTCACGATGCC -> TCACGATGCCT
TTCACTCGTGA -> TCACTCGTGAA
TTCACTCTACG -> TCACTCTACGT
TTCATAAGACA -> TCATAAGACAA
TTCCACTCGAG -> TCCACTCGAGG
TTCCATCTGGA -> TCCATCTGGAA
TTCCATTGTTT -> TCCATTGTTTC
TTCCCATCTCA -> TCCCATCTCAC
TTCCCCCGTTT -> TCCCCCGTTTT
TTCCCCGAGGG -> TCCCCGAGGGT
TTCCCGAAGGA -> TCCCGAAGGAT
TTCCTAGGGCT -> TCCTAGGGCTA
TTCCTGCTCTT -> TCCTGCTCTTT
TTCGACCCCGG -> TCGACCCCGGC
TTCGATCTTTT -> TCGATCTTTTC
TTCGCATTACT -> TCGCATTACTG
TTCGGAAGCTC -> TCGGAAGCTCT
TTCGGAAGTGG -> TCGGAAGTGGA
TTCGGAGCAGG -> TCGGAGCAGGA
TTCGGCGACGG -> TCGGCGACGGT
TTCGGGTACCA -> TCGGGTACCAC
TTCGGTACCAG -> TCGGTACCAGC
TTCGTCAAGTA -> TCGTCAAGTAC
TTCGTTTGGTA -> TCGTTTGGTAA
TTCTACCCTGT -> TCTACCCTGTT
TTCTATAAACG -> TCTATAAACGA
TTCTATCATTT -> TCTATCATTTA
TTCTGAGAGTT -> TCTGAGAGTTG
TTCTTATCATT -> TCTTATCATTT
TTCTTGGTATT -> TCTTGGTATTG
TTCTTGGTGTT -> TCTTGGTGTTC
TTCTTGTAACA -> TCTTGTAACAT
TTGACGCTTGA -> TGACGCTTGAT
TTGACTAACCC -> TGACTAACCCC
TTGAGTTGGTC -> TGAGTTGGTCA
TTGATAGCTAC -> TGATAGCTACA
TTGATGAAATG -> TGATGAAATGC
TTGATGACTGT -> TGATGACTGTG
TTGATTGTTGT -> TGATTGTTGTG
TTGCGCCCACT -> TGCGCCCACTC
TTGCGTAGTCT -> TGCGTAGTCTG
TTGGAAGGGGT -> TGGAAGGGGTT
TTGGACGTACA -> TGGACGTACAC
TTGGGCAAGGA -> TGGGCAAGGAT
TTGGGGGTATG -> TGGGGGTATGC
TTGGGTTAGTC -> TGGGTTAGTCT
TTGGTAACCTG -> TGGTAACCTGC
TTGGTATTGTG -> TGGTATTGTGG
TTGGTCATTTA -> TGGTCATTTAA
TTGGTGTTCAC -> TGGTGTTCACA
TTGGTTTAATT -> TGGTTTAATTT
TTGTAACATTC -> TGTAACATTCC
TTGTAGAGGAG -> TGTAGAGGAGG
TTGTCGTCAAC -> TGTCGTCAACG
TTGTCTCAGTC -> TGTCTCAGTCC
TTGTCTCGCAT -> TGTCTCGCATC
TTGTGCACGCA -> TGTGCACGCAC
TTGTGGCATCT -> TGTGGCATCTC
TTGTGGTTTCC -> TGTGGTTTCCT
TTGTGTAGCAA -> TGTGTAGCAAT
TTGTGTATCGC -> TGTGTATCGCG
TTGTGTTAGAC -> TGTGTTAGACT
TTGTTAATATC -> TGTTAATATCT
TTGTTGTGTAG -> TGTTGTGTAGC
TTGTTTCACTC -> TGTTTCACTCT
TTTAAACGGCT -> TTAAACGGCTG
TTTAAGGAACC -> TTAAGGAACCA
TTTAATTATTC -> TTAATTATTCG
TTTAATTGTGG -> TTAATTGTGGC
TTTAATTTAAA -> TTAATTTAAAC
TTTAATTTCGT -> TTAATTTCGTC
TTTACAGCTAA -> TTACAGCTAAT
TTTACAGTGAC -> TTACAGTGACC
TTTAGAGGATG -> TTAGAGGATGA
TTTAGATGGCC -> TTAGATGGCCG
TTTAGGGCCAA -> TTAGGGCCAAG
TTTAGTCGATC -> TTAGTCGATCT
TTTAGTGGCCG -> TTAGTGGCCGA
TTTCAACCGTG -> TTCAACCGTGA
TTTCACGATGC -> TTCACGATGCC
TTTCACTCTAC -> TTCACTCTACG
TTTCATAAGAC -> TTCATAAGACA
TTTCCATTGTT -> TTCCATTGTTT
TTTCCCCGAGG -> TTCCCCGAGGG
TTTCCTAGGGC -> TTCCTAGGGCT
TTTCGCATTAC -> TTCGCATTACT
TTTCGGAGCAG -> TTCGGAGCAGG
TTTCGGCGACG -> TTCGGCGACGG
TTTCGTCAAGT -> TTCGTCAAGTA
TTTCTACCCTG -> TTCTACCCTGT
TTTCTGAGAGT -> TTCTGAGAGTT
TTTCTTGGTAT -> TTCTTGGTATT
TTTCTTGGTGT -> TTCTTGGTGTT
TTTGACGCTTG -> TTGACGCTTGA
TTTGCGCCCAC -> TTGCGCCCACT
TTTGCGTAGTC -> TTGCGTAGTCT
TTTGGACGTAC -> TTGGACGTACA
TTTGGTAACCT -> TTGGTAACCTG
TTTGTCGTCAA -> TTGTCGTCAAC
TTTGTGTTAGA -> TTGTGTTAGAC
TTTGTTAATAT -> TTGTTAATATC
TTTTAATTATT -> TTTAATTATTC
TTTTACAGCTA -> TTTACAGCTAA
TTTTACAGTGA -> TTTACAGTGAC
TTTTCACGATG -> TTTCACGATGC
TTTTCTACCCT -> TTTCTACCCTG
TTTTCTGAGAG -> TTTCTGAGAGT
TTTTGCGCCCA -> TTTGCGCCCAC
TTTTGTGTTAG -> TTTGTGTTAGA
TTTTGTTAATA -> TTTGTTAATAT
TTTTTAATTAT -> TTTTAATTATT
TTTTTACAGTG -> TTTTACAGTGA
